exp,prod,sum,const,nodes,unique_feats,filename,algo
0,0,0,8,8,8,COIL20_new/COIL20_run_5/COIL20-0.09127597762500983-16.0.tree,NEW
6,6,3,32,47,26,COIL20_new/COIL20_run_5/COIL20-0.028470196177062312-397.0.tree,NEW
6,3,2,28,39,22,COIL20_new/COIL20_run_5/COIL20-0.031470803990610086-104.0.tree,NEW
1,1,0,17,19,17,COIL20_new/COIL20_run_5/COIL20-0.0552640379312917-46.0.tree,NEW
1,1,0,16,18,16,COIL20_new/COIL20_run_5/COIL20-0.05681291452418208-44.0.tree,NEW
6,1,2,25,34,22,COIL20_new/COIL20_run_5/COIL20-0.03492862266189711-92.0.tree,NEW
6,2,3,28,39,26,COIL20_new/COIL20_run_5/COIL20-0.02934989567031787-190.0.tree,NEW
6,6,3,32,47,28,COIL20_new/COIL20_run_5/COIL20-0.028680858297935652-252.0.tree,NEW
7,9,6,38,60,31,COIL20_new/COIL20_run_5/COIL20-0.02765729795439348-574.0.tree,NEW
0,0,0,5,5,5,COIL20_new/COIL20_run_5/COIL20-0.1272081214136671-10.0.tree,NEW
6,4,2,29,41,23,COIL20_new/COIL20_run_5/COIL20-0.030420485878232484-115.0.tree,NEW
0,0,0,7,7,7,COIL20_new/COIL20_run_5/COIL20-0.09946692888814396-14.0.tree,NEW
4,1,1,24,30,21,COIL20_new/COIL20_run_5/COIL20-0.03650237070571638-76.0.tree,NEW
1,0,0,1,2,1,COIL20_new/COIL20_run_5/COIL20-0.27782004527163007-4.0.tree,NEW
1,1,1,20,23,18,COIL20_new/COIL20_run_5/COIL20-0.04781045066696449-52.0.tree,NEW
1,1,1,19,22,17,COIL20_new/COIL20_run_5/COIL20-0.05055015276846281-50.0.tree,NEW
6,3,3,29,41,27,COIL20_new/COIL20_run_5/COIL20-0.029045057381325845-193.0.tree,NEW
5,2,2,26,35,23,COIL20_new/COIL20_run_5/COIL20-0.03536763404501142-83.0.tree,NEW
6,7,6,36,55,29,COIL20_new/COIL20_run_5/COIL20-0.02772860542886979-540.0.tree,NEW
7,1,2,26,36,21,COIL20_new/COIL20_run_5/COIL20-0.03128892568373309-106.0.tree,NEW
3,1,1,23,28,21,COIL20_new/COIL20_run_5/COIL20-0.04092243274461593-72.0.tree,NEW
1,1,0,15,17,14,COIL20_new/COIL20_run_5/COIL20-0.05872102988300221-42.0.tree,NEW
0,0,0,9,9,9,COIL20_new/COIL20_run_5/COIL20-0.0875301694425819-18.0.tree,NEW
1,1,1,21,24,19,COIL20_new/COIL20_run_5/COIL20-0.04617247466279184-54.0.tree,NEW
0,0,1,4,5,4,COIL20_new/COIL20_run_5/COIL20-0.14511376127133235-8.0.tree,NEW
5,1,1,24,31,21,COIL20_new/COIL20_run_5/COIL20-0.035764238207019794-78.0.tree,NEW
6,4,3,30,43,26,COIL20_new/COIL20_run_5/COIL20-0.028534854963112033-385.0.tree,NEW
0,1,0,10,11,9,COIL20_new/COIL20_run_5/COIL20-0.08242243973097896-20.0.tree,NEW
0,0,0,3,3,3,COIL20_new/COIL20_run_5/COIL20-0.15432760917355914-6.0.tree,NEW
7,5,5,33,50,27,COIL20_new/COIL20_run_5/COIL20-0.028267044396006136-409.0.tree,NEW
2,1,1,23,27,22,COIL20_new/COIL20_run_5/COIL20-0.042654689712348204-60.0.tree,NEW
6,8,5,36,55,30,COIL20_new/COIL20_run_5/COIL20-0.02775778513674626-433.0.tree,NEW
0,0,0,6,6,6,COIL20_new/COIL20_run_5/COIL20-0.12403779156420003-12.0.tree,NEW
7,2,2,27,38,23,COIL20_new/COIL20_run_5/COIL20-0.031100154165734917-109.0.tree,NEW
1,1,0,11,13,10,COIL20_new/COIL20_run_5/COIL20-0.07162031215068176-26.0.tree,NEW
6,1,3,27,37,25,COIL20_new/COIL20_run_5/COIL20-0.029896275802965278-142.0.tree,NEW
1,1,0,14,16,14,COIL20_new/COIL20_run_5/COIL20-0.06522781364110614-30.0.tree,NEW
5,6,3,32,46,27,COIL20_new/COIL20_run_5/COIL20-0.028307576943140178-399.0.tree,NEW
7,2,3,28,40,26,COIL20_new/COIL20_run_5/COIL20-0.029572748993964004-149.0.tree,NEW
2,1,1,22,26,21,COIL20_new/COIL20_run_5/COIL20-0.04446500763842359-58.0.tree,NEW
6,1,2,26,35,23,COIL20_new/COIL20_run_5/COIL20-0.032049298103435986-94.0.tree,NEW
8,6,6,36,56,32,COIL20_new/COIL20_run_5/COIL20-0.02747696829122953-8480.0.tree,NEW
7,5,3,31,46,27,COIL20_new/COIL20_run_5/COIL20-0.028999285062224656-228.0.tree,NEW
7,10,6,39,62,30,COIL20_new/COIL20_run_5/COIL20-0.027645036887994467-631.0.tree,NEW
0,1,0,11,12,11,COIL20_new/COIL20_run_5/COIL20-0.07503805238840416-22.0.tree,NEW
3,1,1,24,29,23,COIL20_new/COIL20_run_5/COIL20-0.03831831265370056-74.0.tree,NEW
7,1,3,27,38,26,COIL20_new/COIL20_run_5/COIL20-0.02978591456144214-144.0.tree,NEW
1,1,1,22,25,20,COIL20_new/COIL20_run_5/COIL20-0.04483810269021571-56.0.tree,NEW
6,2,2,26,36,22,COIL20_new/COIL20_run_5/COIL20-0.03526671603696263-87.0.tree,NEW
0,0,0,1,1,1,COIL20_new/COIL20_run_5/COIL20-1.2050469483568054-2.0.tree,NEW
6,7,5,35,53,30,COIL20_new/COIL20_run_5/COIL20-0.02801768947015365-417.0.tree,NEW
0,1,0,17,18,16,COIL20_new/COIL20_run_2/COIL20-0.05254952166703947-34.0.tree,NEW
13,3,19,42,77,34,COIL20_new/COIL20_run_2/COIL20-0.024498705194127335-25937.5.tree,NEW
12,3,20,43,78,32,COIL20_new/COIL20_run_2/COIL20-0.024318049500708205-32598.5.tree,NEW
1,1,0,10,12,10,COIL20_new/COIL20_run_2/COIL20-0.06988193047171942-24.0.tree,NEW
0,1,0,7,8,6,COIL20_new/COIL20_run_2/COIL20-0.12262727988300193-14.0.tree,NEW
0,1,0,20,21,19,COIL20_new/COIL20_run_2/COIL20-0.04428120808182351-40.0.tree,NEW
0,0,0,1,1,1,COIL20_new/COIL20_run_2/COIL20-0.27521660052910024-2.0.tree,NEW
12,3,16,39,70,33,COIL20_new/COIL20_run_2/COIL20-0.024754254694835942-2963.0.tree,NEW
0,1,0,19,20,18,COIL20_new/COIL20_run_2/COIL20-0.046617459385945303-38.0.tree,NEW
13,5,17,42,77,31,COIL20_new/COIL20_run_2/COIL20-0.024682807493106584-3653.0.tree,NEW
1,2,0,22,25,21,COIL20_new/COIL20_run_2/COIL20-0.03683238318801679-48.0.tree,NEW
5,3,6,29,43,25,COIL20_new/COIL20_run_2/COIL20-0.03046835410611798-113.0.tree,NEW
7,3,9,32,51,27,COIL20_new/COIL20_run_2/COIL20-0.026825420113272935-166.0.tree,NEW
13,3,15,38,69,31,COIL20_new/COIL20_run_2/COIL20-0.02531375754527132-1041.0.tree,NEW
0,0,0,6,6,6,COIL20_new/COIL20_run_2/COIL20-0.13766497130933764-12.0.tree,NEW
0,1,0,5,6,5,COIL20_new/COIL20_run_2/COIL20-0.14134121860794363-10.0.tree,NEW
2,2,0,22,26,21,COIL20_new/COIL20_run_2/COIL20-0.03344928366495281-50.0.tree,NEW
0,0,0,3,3,3,COIL20_new/COIL20_run_2/COIL20-0.1624246171473291-6.0.tree,NEW
0,0,0,4,4,4,COIL20_new/COIL20_run_2/COIL20-0.15777955930024568-8.0.tree,NEW
3,3,3,26,35,23,COIL20_new/COIL20_run_2/COIL20-0.031041620090915878-81.0.tree,NEW
7,3,9,32,51,26,COIL20_new/COIL20_run_2/COIL20-0.02691621953945944-161.0.tree,NEW
8,3,11,34,56,30,COIL20_new/COIL20_run_2/COIL20-0.025508118153364956-295.0.tree,NEW
2,2,2,24,30,22,COIL20_new/COIL20_run_2/COIL20-0.03259438575899842-55.0.tree,NEW
13,4,17,41,75,31,COIL20_new/COIL20_run_2/COIL20-0.024702520679633633-3492.0.tree,NEW
11,3,14,37,65,30,COIL20_new/COIL20_run_2/COIL20-0.025233065057008508-1196.0.tree,NEW
11,4,16,40,71,32,COIL20_new/COIL20_run_2/COIL20-0.024826249161636726-1640.0.tree,NEW
0,0,0,2,2,2,COIL20_new/COIL20_run_2/COIL20-0.19750770828675746-4.0.tree,NEW
6,3,5,29,43,24,COIL20_new/COIL20_run_2/COIL20-0.030428333892242587-125.0.tree,NEW
3,2,4,26,35,23,COIL20_new/COIL20_run_2/COIL20-0.03189902144347612-62.0.tree,NEW
8,3,9,32,52,28,COIL20_new/COIL20_run_2/COIL20-0.025690916331321534-168.0.tree,NEW
4,3,4,27,38,24,COIL20_new/COIL20_run_2/COIL20-0.030528483400401984-87.0.tree,NEW
10,4,16,40,70,34,COIL20_new/COIL20_run_2/COIL20-0.02449968328489399-6196.0.tree,NEW
0,1,0,16,17,15,COIL20_new/COIL20_run_2/COIL20-0.05623325601758705-32.0.tree,NEW
3,2,5,27,37,23,COIL20_new/COIL20_run_2/COIL20-0.03188281308219726-75.0.tree,NEW
0,1,0,13,14,12,COIL20_new/COIL20_run_2/COIL20-0.06488137156270979-26.0.tree,NEW
1,1,0,21,23,20,COIL20_new/COIL20_run_2/COIL20-0.03944344306580233-46.0.tree,NEW
0,1,0,21,22,21,COIL20_new/COIL20_run_2/COIL20-0.03970071586929019-42.0.tree,NEW
0,1,0,9,10,8,COIL20_new/COIL20_run_2/COIL20-0.10593846644682897-18.0.tree,NEW
2,2,4,26,34,23,COIL20_new/COIL20_run_2/COIL20-0.03236104124748507-58.0.tree,NEW
12,3,13,37,65,30,COIL20_new/COIL20_run_2/COIL20-0.025091672721514136-1371.0.tree,NEW
8,3,8,32,51,26,COIL20_new/COIL20_run_2/COIL20-0.027160742231164325-160.0.tree,NEW
11,3,14,37,65,30,COIL20_new/COIL20_run_2/COIL20-0.024945739250317123-1548.0.tree,NEW
0,1,0,11,12,10,COIL20_new/COIL20_run_2/COIL20-0.07519909969073713-22.0.tree,NEW
8,3,4,28,43,24,COIL20_new/COIL20_run_2/COIL20-0.030267344809597696-132.0.tree,NEW
8,3,8,31,50,26,COIL20_new/COIL20_run_2/COIL20-0.02719905078619861-153.0.tree,NEW
0,1,0,15,16,14,COIL20_new/COIL20_run_2/COIL20-0.05789550963186513-30.0.tree,NEW
0,1,0,10,11,9,COIL20_new/COIL20_run_2/COIL20-0.09557093719725734-20.0.tree,NEW
0,1,0,18,19,17,COIL20_new/COIL20_run_2/COIL20-0.05021929027871058-36.0.tree,NEW
1,0,1,17,19,17,COIL20_new/COIL20_run_3/COIL20-0.05634678441016494-36.0.tree,NEW
1,0,1,13,15,13,COIL20_new/COIL20_run_3/COIL20-0.07330267484536868-28.0.tree,NEW
1,0,1,16,18,16,COIL20_new/COIL20_run_3/COIL20-0.05947580156867133-34.0.tree,NEW
1,0,1,18,20,18,COIL20_new/COIL20_run_3/COIL20-0.05163370267903672-38.0.tree,NEW
9,0,7,29,45,24,COIL20_new/COIL20_run_3/COIL20-0.030392994541322493-107.0.tree,NEW
5,0,4,26,35,23,COIL20_new/COIL20_run_3/COIL20-0.032122748062449136-84.0.tree,NEW
5,0,3,25,33,22,COIL20_new/COIL20_run_3/COIL20-0.03244733446978215-81.0.tree,NEW
6,0,4,26,36,23,COIL20_new/COIL20_run_3/COIL20-0.031055674323719584-86.0.tree,NEW
2,0,0,9,11,9,COIL20_new/COIL20_run_3/COIL20-0.08967740470601387-22.0.tree,NEW
0,0,0,2,2,2,COIL20_new/COIL20_run_3/COIL20-0.23254919563678372-4.0.tree,NEW
3,0,2,22,27,21,COIL20_new/COIL20_run_3/COIL20-0.03816505514568913-51.0.tree,NEW
6,0,5,27,38,23,COIL20_new/COIL20_run_3/COIL20-0.03089251946866478-101.0.tree,NEW
9,0,8,30,47,23,COIL20_new/COIL20_run_3/COIL20-0.030372990256352983-121.0.tree,NEW
1,0,1,21,23,21,COIL20_new/COIL20_run_3/COIL20-0.03917968458901505-44.0.tree,NEW
9,0,9,31,49,28,COIL20_new/COIL20_run_3/COIL20-0.02774699120649865-148.0.tree,NEW
10,0,13,35,58,30,COIL20_new/COIL20_run_3/COIL20-0.02654083063194007-187.0.tree,NEW
6,0,5,27,38,23,COIL20_new/COIL20_run_3/COIL20-0.030905735337953433-97.0.tree,NEW
0,0,0,4,4,4,COIL20_new/COIL20_run_3/COIL20-0.1533877105223933-8.0.tree,NEW
10,2,19,43,74,35,COIL20_new/COIL20_run_3/COIL20-0.025564172069455215-10622.25.tree,NEW
10,2,18,42,72,35,COIL20_new/COIL20_run_3/COIL20-0.025634373369848473-3456.0.tree,NEW
1,0,0,9,10,9,COIL20_new/COIL20_run_3/COIL20-0.09105448664207405-20.0.tree,NEW
10,1,17,40,68,34,COIL20_new/COIL20_run_3/COIL20-0.025685420392726865-1171.0.tree,NEW
1,0,0,7,8,7,COIL20_new/COIL20_run_3/COIL20-0.10415232133541907-16.0.tree,NEW
0,0,0,1,1,1,COIL20_new/COIL20_run_3/COIL20-1.3233959311424075-2.0.tree,NEW
10,1,15,38,64,32,COIL20_new/COIL20_run_3/COIL20-0.02602675078247263-1029.0.tree,NEW
10,0,15,37,62,30,COIL20_new/COIL20_run_3/COIL20-0.026344339183248633-484.0.tree,NEW
10,0,14,36,60,31,COIL20_new/COIL20_run_3/COIL20-0.02619438855354317-528.0.tree,NEW
10,0,12,34,56,29,COIL20_new/COIL20_run_3/COIL20-0.02670177313883293-173.0.tree,NEW
1,0,0,8,9,8,COIL20_new/COIL20_run_3/COIL20-0.09439267549742936-18.0.tree,NEW
2,0,1,21,24,21,COIL20_new/COIL20_run_3/COIL20-0.03865348340040242-46.0.tree,NEW
1,0,1,15,17,15,COIL20_new/COIL20_run_3/COIL20-0.06416816873463-32.0.tree,NEW
9,2,18,41,70,37,COIL20_new/COIL20_run_3/COIL20-0.0256028765183694-6662.0.tree,NEW
7,0,6,28,41,24,COIL20_new/COIL20_run_3/COIL20-0.030469623295327708-103.0.tree,NEW
10,0,8,30,48,25,COIL20_new/COIL20_run_3/COIL20-0.029000926857440712-126.0.tree,NEW
1,0,1,19,21,19,COIL20_new/COIL20_run_3/COIL20-0.04946874534242485-40.0.tree,NEW
0,0,1,13,14,13,COIL20_new/COIL20_run_3/COIL20-0.08027128046054038-26.0.tree,NEW
1,0,0,20,21,20,COIL20_new/COIL20_run_3/COIL20-0.040880747447649135-42.0.tree,NEW
3,0,2,23,28,21,COIL20_new/COIL20_run_3/COIL20-0.0372612876332068-62.0.tree,NEW
10,1,15,38,64,32,COIL20_new/COIL20_run_3/COIL20-0.026103251453163112-1024.0.tree,NEW
10,0,11,33,54,30,COIL20_new/COIL20_run_3/COIL20-0.026840976414038986-165.0.tree,NEW
4,0,3,25,32,22,COIL20_new/COIL20_run_3/COIL20-0.033463908450704904-79.0.tree,NEW
10,1,14,37,62,33,COIL20_new/COIL20_run_3/COIL20-0.026117433769281717-576.0.tree,NEW
1,0,0,6,7,6,COIL20_new/COIL20_run_3/COIL20-0.12231032025486238-14.0.tree,NEW
10,1,16,39,66,35,COIL20_new/COIL20_run_3/COIL20-0.025847212907072425-1045.0.tree,NEW
1,0,1,14,16,14,COIL20_new/COIL20_run_3/COIL20-0.06990702315746333-30.0.tree,NEW
8,25,5,52,90,28,COIL20_new/COIL20_run_4/COIL20-0.02689258234592723-193143.5.tree,NEW
8,19,5,46,78,28,COIL20_new/COIL20_run_4/COIL20-0.026895144012221484-11154.0.tree,NEW
8,5,4,30,47,28,COIL20_new/COIL20_run_4/COIL20-0.027901133653774612-115.0.tree,NEW
8,15,5,42,70,28,COIL20_new/COIL20_run_4/COIL20-0.02696489119904566-2934.0.tree,NEW
9,8,4,34,55,28,COIL20_new/COIL20_run_4/COIL20-0.027235787409642-256.0.tree,NEW
8,19,5,46,78,28,COIL20_new/COIL20_run_4/COIL20-0.02691978258439509-5325.75.tree,NEW
7,8,4,33,52,28,COIL20_new/COIL20_run_4/COIL20-0.02750931515015903-211.0.tree,NEW
1,0,1,8,10,8,COIL20_new/COIL20_run_4/COIL20-0.1003505873202174-18.0.tree,NEW
3,3,3,26,35,24,COIL20_new/COIL20_run_4/COIL20-0.03649934328191401-64.0.tree,NEW
0,2,1,17,20,16,COIL20_new/COIL20_run_4/COIL20-0.0653853095424397-35.0.tree,NEW
7,8,5,34,54,29,COIL20_new/COIL20_run_4/COIL20-0.027385609956032564-224.0.tree,NEW
2,1,3,24,30,23,COIL20_new/COIL20_run_4/COIL20-0.039540704877413124-52.0.tree,NEW
0,2,1,18,21,17,COIL20_new/COIL20_run_4/COIL20-0.06366732804232833-37.0.tree,NEW
2,2,3,25,32,23,COIL20_new/COIL20_run_4/COIL20-0.038587252682763695-55.0.tree,NEW
7,11,5,37,60,27,COIL20_new/COIL20_run_4/COIL20-0.027464602429390694-215.0.tree,NEW
0,1,1,16,18,14,COIL20_new/COIL20_run_4/COIL20-0.06819626089872555-32.0.tree,NEW
8,13,5,40,66,30,COIL20_new/COIL20_run_4/COIL20-0.027208924845368576-396.0.tree,NEW
0,0,0,1,1,1,COIL20_new/COIL20_run_4/COIL20-0.2825053212795292-2.0.tree,NEW
2,1,2,23,28,22,COIL20_new/COIL20_run_4/COIL20-0.040719292607497404-50.0.tree,NEW
9,28,5,56,98,29,COIL20_new/COIL20_run_4/COIL20-0.026889100808555333-656782.25.tree,NEW
8,19,5,46,78,28,COIL20_new/COIL20_run_4/COIL20-0.02693507107459525-3772.75.tree,NEW
8,15,5,42,70,28,COIL20_new/COIL20_run_4/COIL20-0.027034079476861594-907.25.tree,NEW
1,1,2,23,27,22,COIL20_new/COIL20_run_4/COIL20-0.042110160965794396-48.0.tree,NEW
5,3,3,26,37,24,COIL20_new/COIL20_run_4/COIL20-0.035501492752813-78.0.tree,NEW
0,0,0,4,4,4,COIL20_new/COIL20_run_4/COIL20-0.1587127277554216-8.0.tree,NEW
8,18,6,46,78,28,COIL20_new/COIL20_run_4/COIL20-0.02691871134212709-10321.0.tree,NEW
8,14,5,41,68,30,COIL20_new/COIL20_run_4/COIL20-0.027159636057082215-460.0.tree,NEW
8,17,5,44,74,28,COIL20_new/COIL20_run_4/COIL20-0.026905099578955094-10950.0.tree,NEW
0,1,0,7,8,7,COIL20_new/COIL20_run_4/COIL20-0.12249498146285148-14.0.tree,NEW
0,1,0,8,9,7,COIL20_new/COIL20_run_4/COIL20-0.11323814414263395-16.0.tree,NEW
7,10,5,36,58,29,COIL20_new/COIL20_run_4/COIL20-0.027646096486324934-165.0.tree,NEW
5,4,4,28,41,26,COIL20_new/COIL20_run_4/COIL20-0.03434916210224381-85.0.tree,NEW
8,25,5,52,90,28,COIL20_new/COIL20_run_4/COIL20-0.026894980997093088-41627.75.tree,NEW
7,10,5,36,58,28,COIL20_new/COIL20_run_4/COIL20-0.027793159419479574-162.0.tree,NEW
5,6,4,30,45,26,COIL20_new/COIL20_run_4/COIL20-0.032105258868023845-111.0.tree,NEW
8,19,5,46,78,29,COIL20_new/COIL20_run_4/COIL20-0.026926664151576407-4374.5.tree,NEW
0,0,0,3,3,3,COIL20_new/COIL20_run_4/COIL20-0.16272639308070636-6.0.tree,NEW
1,1,2,22,26,21,COIL20_new/COIL20_run_4/COIL20-0.04771599504434065-46.0.tree,NEW
9,13,5,40,67,30,COIL20_new/COIL20_run_4/COIL20-0.02712388916834335-629.0.tree,NEW
2,3,3,26,34,23,COIL20_new/COIL20_run_4/COIL20-0.0384875107124229-62.0.tree,NEW
0,0,0,6,6,6,COIL20_new/COIL20_run_4/COIL20-0.13376139941500848-12.0.tree,NEW
5,2,3,25,35,24,COIL20_new/COIL20_run_4/COIL20-0.035552761010507306-71.0.tree,NEW
0,0,0,2,2,2,COIL20_new/COIL20_run_4/COIL20-0.174186298345629-4.0.tree,NEW
8,17,5,44,74,28,COIL20_new/COIL20_run_4/COIL20-0.02696688231239286-1400.0.tree,NEW
1,1,2,21,25,20,COIL20_new/COIL20_run_4/COIL20-0.050665567478948015-44.0.tree,NEW
4,6,4,30,44,26,COIL20_new/COIL20_run_4/COIL20-0.03393064404948232-95.0.tree,NEW
2,0,2,22,26,21,COIL20_new/COIL20_run_17/COIL20-0.041740640602876355-58.0.tree,NEW
8,4,8,35,55,31,COIL20_new/COIL20_run_17/COIL20-0.0244302737722632-3537.0.tree,NEW
4,0,3,26,33,24,COIL20_new/COIL20_run_17/COIL20-0.02875295756017643-90.0.tree,NEW
5,3,4,30,42,29,COIL20_new/COIL20_run_17/COIL20-0.025404510395707458-118.0.tree,NEW
1,0,2,20,23,19,COIL20_new/COIL20_run_17/COIL20-0.04918663601982226-52.0.tree,NEW
2,1,0,10,13,9,COIL20_new/COIL20_run_17/COIL20-0.13486830706461006-34.0.tree,NEW
5,1,4,28,38,25,COIL20_new/COIL20_run_17/COIL20-0.028093549724272304-108.0.tree,NEW
5,2,4,29,40,25,COIL20_new/COIL20_run_17/COIL20-0.026829053021834637-111.0.tree,NEW
8,4,7,34,53,31,COIL20_new/COIL20_run_17/COIL20-0.02440671808629552-7633.0.tree,NEW
6,1,4,28,39,25,COIL20_new/COIL20_run_17/COIL20-0.027945578563976725-110.0.tree,NEW
0,0,0,2,2,2,COIL20_new/COIL20_run_17/COIL20-0.22243341996422938-4.0.tree,NEW
4,2,3,28,37,26,COIL20_new/COIL20_run_17/COIL20-0.028716523679111483-100.0.tree,NEW
2,0,2,23,27,22,COIL20_new/COIL20_run_17/COIL20-0.03876377477829929-60.0.tree,NEW
14,4,9,37,64,33,COIL20_new/COIL20_run_17/COIL20-0.024139710950891125-173773.0.tree,NEW
7,4,7,34,52,31,COIL20_new/COIL20_run_17/COIL20-0.02456358521499369-3025.0.tree,NEW
7,3,7,33,50,31,COIL20_new/COIL20_run_17/COIL20-0.024577127114539132-894.0.tree,NEW
3,0,2,23,28,22,COIL20_new/COIL20_run_17/COIL20-0.03827869997764344-62.0.tree,NEW
2,0,2,21,25,20,COIL20_new/COIL20_run_17/COIL20-0.046688988095238915-56.0.tree,NEW
5,1,3,27,36,24,COIL20_new/COIL20_run_17/COIL20-0.028725256632386453-97.0.tree,NEW
3,1,0,10,14,9,COIL20_new/COIL20_run_17/COIL20-0.13363548187271845-38.0.tree,NEW
6,3,5,31,45,29,COIL20_new/COIL20_run_17/COIL20-0.02468440271257244-237.0.tree,NEW
7,4,8,35,54,32,COIL20_new/COIL20_run_17/COIL20-0.02451626425217901-3473.0.tree,NEW
13,5,9,38,65,33,COIL20_new/COIL20_run_17/COIL20-0.024232175460168315-95060.0.tree,NEW
10,4,8,35,57,32,COIL20_new/COIL20_run_17/COIL20-0.024288404035323286-27117.0.tree,NEW
0,0,0,1,1,1,COIL20_new/COIL20_run_17/COIL20-0.2744710275542147-2.0.tree,NEW
3,0,3,25,31,23,COIL20_new/COIL20_run_17/COIL20-0.03251201654370728-76.0.tree,NEW
3,0,1,12,16,11,COIL20_new/COIL20_run_17/COIL20-0.08129846206870911-40.0.tree,NEW
0,1,0,7,8,7,COIL20_new/COIL20_run_28/COIL20-0.1171049328377678-14.0.tree,NEW
6,3,5,31,45,29,COIL20_new/COIL20_run_28/COIL20-0.028254597026604267-922.0.tree,NEW
3,1,1,23,28,23,COIL20_new/COIL20_run_28/COIL20-0.03203985486996175-62.0.tree,NEW
2,2,1,24,29,24,COIL20_new/COIL20_run_28/COIL20-0.031822171454653936-72.0.tree,NEW
5,3,5,31,44,30,COIL20_new/COIL20_run_28/COIL20-0.027782388777107148-4714.0.tree,NEW
1,0,0,2,3,2,COIL20_new/COIL20_run_28/COIL20-0.1844467266562338-6.0.tree,NEW
4,3,2,27,36,26,COIL20_new/COIL20_run_28/COIL20-0.028280702734929053-586.0.tree,NEW
4,1,2,26,33,25,COIL20_new/COIL20_run_28/COIL20-0.028799510023101493-116.0.tree,NEW
0,0,0,2,2,2,COIL20_new/COIL20_run_28/COIL20-0.24885975575676272-4.0.tree,NEW
3,1,2,25,31,25,COIL20_new/COIL20_run_28/COIL20-0.02920494028988707-87.0.tree,NEW
4,1,3,27,35,26,COIL20_new/COIL20_run_28/COIL20-0.028634189395632226-230.0.tree,NEW
1,0,1,20,22,20,COIL20_new/COIL20_run_28/COIL20-0.04135119746255206-42.0.tree,NEW
6,3,2,28,39,27,COIL20_new/COIL20_run_28/COIL20-0.028257263488337236-711.0.tree,NEW
0,0,2,11,13,11,COIL20_new/COIL20_run_28/COIL20-0.08636826747522164-22.0.tree,NEW
0,0,2,12,14,12,COIL20_new/COIL20_run_28/COIL20-0.08207890863700706-24.0.tree,NEW
0,0,0,1,1,1,COIL20_new/COIL20_run_28/COIL20-1.1236991392801223-2.0.tree,NEW
5,1,3,28,37,27,COIL20_new/COIL20_run_28/COIL20-0.02862061256427456-453.0.tree,NEW
6,3,4,31,44,30,COIL20_new/COIL20_run_28/COIL20-0.02815922153290118-965.0.tree,NEW
1,0,1,14,16,14,COIL20_new/COIL20_run_28/COIL20-0.06799185157239745-40.0.tree,NEW
0,1,0,6,7,6,COIL20_new/COIL20_run_28/COIL20-0.13562774796929727-12.0.tree,NEW
3,2,1,24,30,24,COIL20_new/COIL20_run_28/COIL20-0.03069899722408509-74.0.tree,NEW
0,0,0,4,4,4,COIL20_new/COIL20_run_28/COIL20-0.13982227857888058-8.0.tree,NEW
0,1,1,22,24,22,COIL20_new/COIL20_run_28/COIL20-0.03819429307325373-44.0.tree,NEW
3,0,4,16,23,15,COIL20_new/COIL20_run_28/COIL20-0.0800487298792758-39.0.tree,NEW
1,1,1,22,25,22,COIL20_new/COIL20_run_28/COIL20-0.036150747075041956-46.0.tree,NEW
1,1,1,23,26,23,COIL20_new/COIL20_run_28/COIL20-0.034540646657724994-58.0.tree,NEW
5,3,2,28,38,28,COIL20_new/COIL20_run_28/COIL20-0.02827015332737154-615.0.tree,NEW
2,1,1,23,27,23,COIL20_new/COIL20_run_28/COIL20-0.032651278038600684-60.0.tree,NEW
6,2,3,28,39,27,COIL20_new/COIL20_run_21/COIL20-0.027675567292645475-114.0.tree,NEW
4,1,2,25,32,24,COIL20_new/COIL20_run_21/COIL20-0.03040842275877431-78.0.tree,NEW
2,0,0,13,15,12,COIL20_new/COIL20_run_21/COIL20-0.07112022831432979-40.0.tree,NEW
2,0,0,14,16,13,COIL20_new/COIL20_run_21/COIL20-0.06527288732394365-42.0.tree,NEW
7,3,3,29,42,28,COIL20_new/COIL20_run_21/COIL20-0.027610198226395433-129.0.tree,NEW
0,0,0,9,9,9,COIL20_new/COIL20_run_21/COIL20-0.09148853770772747-18.0.tree,NEW
6,1,3,27,37,25,COIL20_new/COIL20_run_21/COIL20-0.028354956125641706-111.0.tree,NEW
3,1,2,24,30,22,COIL20_new/COIL20_run_21/COIL20-0.03859372671212369-64.0.tree,NEW
0,0,1,10,11,10,COIL20_new/COIL20_run_21/COIL20-0.08914234248081099-20.0.tree,NEW
0,0,0,4,4,4,COIL20_new/COIL20_run_21/COIL20-0.1351578917952156-8.0.tree,NEW
6,1,2,26,35,23,COIL20_new/COIL20_run_21/COIL20-0.029056596523585443-94.0.tree,NEW
3,1,2,25,31,24,COIL20_new/COIL20_run_21/COIL20-0.030829583985393705-76.0.tree,NEW
9,1,3,28,41,27,COIL20_new/COIL20_run_21/COIL20-0.026840172982338095-384.0.tree,NEW
2,0,0,15,17,14,COIL20_new/COIL20_run_21/COIL20-0.06522925748938074-44.0.tree,NEW
1,0,0,14,15,14,COIL20_new/COIL20_run_21/COIL20-0.07144210168417892-30.0.tree,NEW
0,0,0,7,7,7,COIL20_new/COIL20_run_21/COIL20-0.1056942814293172-14.0.tree,NEW
2,1,0,20,23,18,COIL20_new/COIL20_run_21/COIL20-0.04754772850063266-54.0.tree,NEW
2,1,1,24,28,22,COIL20_new/COIL20_run_21/COIL20-0.036197101591028125-72.0.tree,NEW
1,0,2,13,16,12,COIL20_new/COIL20_run_21/COIL20-0.07210412940606642-28.0.tree,NEW
0,0,0,1,1,1,COIL20_new/COIL20_run_21/COIL20-0.24437373081079017-2.0.tree,NEW
8,3,3,29,43,28,COIL20_new/COIL20_run_21/COIL20-0.02719349662791598-193.0.tree,NEW
9,2,3,29,43,28,COIL20_new/COIL20_run_21/COIL20-0.027000416852970555-365.0.tree,NEW
0,0,0,3,3,3,COIL20_new/COIL20_run_21/COIL20-0.17096822835159092-6.0.tree,NEW
0,0,0,2,2,2,COIL20_new/COIL20_run_21/COIL20-0.21367666648036382-4.0.tree,NEW
1,1,1,23,26,21,COIL20_new/COIL20_run_21/COIL20-0.04058265099858399-58.0.tree,NEW
7,3,3,29,42,28,COIL20_new/COIL20_run_21/COIL20-0.027398348423876784-145.0.tree,NEW
0,0,2,12,14,11,COIL20_new/COIL20_run_21/COIL20-0.08476044926969228-24.0.tree,NEW
1,0,2,12,15,11,COIL20_new/COIL20_run_21/COIL20-0.0784269855242572-26.0.tree,NEW
1,1,0,19,21,18,COIL20_new/COIL20_run_21/COIL20-0.04817830594679168-50.0.tree,NEW
0,0,0,8,8,8,COIL20_new/COIL20_run_21/COIL20-0.09670886429689285-16.0.tree,NEW
6,1,2,26,35,24,COIL20_new/COIL20_run_21/COIL20-0.028841253539757472-109.0.tree,NEW
1,0,0,5,6,5,COIL20_new/COIL20_run_21/COIL20-0.12665502272896634-12.0.tree,NEW
5,1,2,26,34,25,COIL20_new/COIL20_run_21/COIL20-0.03039845554810411-92.0.tree,NEW
2,1,2,24,29,22,COIL20_new/COIL20_run_21/COIL20-0.039072432278858094-62.0.tree,NEW
8,2,3,29,42,27,COIL20_new/COIL20_run_21/COIL20-0.02714222837022162-341.0.tree,NEW
2,0,0,16,18,15,COIL20_new/COIL20_run_21/COIL20-0.059474963205157105-46.0.tree,NEW
3,1,1,24,29,22,COIL20_new/COIL20_run_21/COIL20-0.03384881045532401-74.0.tree,NEW
9,3,5,31,48,27,COIL20_new/COIL20_run_26/COIL20-0.02826825536552635-143.0.tree,NEW
9,3,7,33,52,29,COIL20_new/COIL20_run_26/COIL20-0.02663062867948407-400.0.tree,NEW
7,0,4,26,37,23,COIL20_new/COIL20_run_26/COIL20-0.03253034410164646-87.0.tree,NEW
8,4,6,33,51,30,COIL20_new/COIL20_run_26/COIL20-0.026604883933229517-752.0.tree,NEW
8,3,6,32,49,28,COIL20_new/COIL20_run_26/COIL20-0.02674997904091192-254.0.tree,NEW
7,1,4,27,39,24,COIL20_new/COIL20_run_26/COIL20-0.031083037577315675-92.0.tree,NEW
1,1,1,5,8,4,COIL20_new/COIL20_run_26/COIL20-0.17917517838512526-15.0.tree,NEW
4,1,1,24,30,21,COIL20_new/COIL20_run_26/COIL20-0.035709476768015225-79.0.tree,NEW
8,0,4,26,38,23,COIL20_new/COIL20_run_26/COIL20-0.03197544060660262-89.0.tree,NEW
8,2,4,29,43,25,COIL20_new/COIL20_run_26/COIL20-0.028689090561889674-115.0.tree,NEW
7,1,4,28,40,25,COIL20_new/COIL20_run_26/COIL20-0.028728796389448696-102.0.tree,NEW
10,3,5,31,49,28,COIL20_new/COIL20_run_26/COIL20-0.02813008840077469-205.0.tree,NEW
0,0,0,9,9,9,COIL20_new/COIL20_run_26/COIL20-0.09917940513451107-18.0.tree,NEW
1,0,0,11,12,10,COIL20_new/COIL20_run_26/COIL20-0.08033298168641456-34.0.tree,NEW
5,1,3,26,35,24,COIL20_new/COIL20_run_26/COIL20-0.033599886355169195-84.0.tree,NEW
0,0,0,1,1,1,COIL20_new/COIL20_run_26/COIL20-0.3146696149116924-2.0.tree,NEW
4,0,1,23,28,21,COIL20_new/COIL20_run_26/COIL20-0.03578346234816293-74.0.tree,NEW
0,0,0,2,2,2,COIL20_new/COIL20_run_26/COIL20-0.18631655674789466-4.0.tree,NEW
8,3,7,33,51,30,COIL20_new/COIL20_run_26/COIL20-0.02633813296445231-4224.0.tree,NEW
3,1,2,20,26,19,COIL20_new/COIL20_run_26/COIL20-0.042232259296520025-46.0.tree,NEW
2,1,2,23,28,22,COIL20_new/COIL20_run_26/COIL20-0.04122045933005519-50.0.tree,NEW
8,3,5,31,47,28,COIL20_new/COIL20_run_26/COIL20-0.028302535118115923-141.0.tree,NEW
2,1,2,20,25,19,COIL20_new/COIL20_run_26/COIL20-0.042600242659661-44.0.tree,NEW
1,0,0,9,10,8,COIL20_new/COIL20_run_26/COIL20-0.09334017996870142-30.0.tree,NEW
8,4,9,36,57,30,COIL20_new/COIL20_run_26/COIL20-0.026182802835531205-524926.0.tree,NEW
1,0,0,10,11,9,COIL20_new/COIL20_run_26/COIL20-0.08683258113495868-32.0.tree,NEW
7,2,5,30,44,27,COIL20_new/COIL20_run_26/COIL20-0.02862593384380291-126.0.tree,NEW
0,0,1,8,9,8,COIL20_new/COIL20_run_26/COIL20-0.11075509771592501-16.0.tree,NEW
3,0,1,23,27,21,COIL20_new/COIL20_run_26/COIL20-0.036928678552798744-72.0.tree,NEW
6,0,3,25,34,22,COIL20_new/COIL20_run_26/COIL20-0.033847215235859596-83.0.tree,NEW
7,3,6,32,48,29,COIL20_new/COIL20_run_26/COIL20-0.026848766208360686-246.0.tree,NEW
9,4,7,34,54,31,COIL20_new/COIL20_run_26/COIL20-0.026474134156792728-898.0.tree,NEW
8,0,4,27,39,24,COIL20_new/COIL20_run_26/COIL20-0.028984916443103637-101.0.tree,NEW
8,1,6,30,45,27,COIL20_new/COIL20_run_26/COIL20-0.02724244774200807-238.0.tree,NEW
2,0,1,22,25,21,COIL20_new/COIL20_run_26/COIL20-0.03847811405469881-58.0.tree,NEW
8,4,7,34,53,29,COIL20_new/COIL20_run_26/COIL20-0.02651468999180273-882.0.tree,NEW
9,3,5,31,48,28,COIL20_new/COIL20_run_26/COIL20-0.028138320664729266-157.0.tree,NEW
1,0,0,12,13,11,COIL20_new/COIL20_run_26/COIL20-0.07127541871599968-36.0.tree,NEW
3,0,0,18,21,17,COIL20_new/COIL20_run_19/COIL20-0.04332014075191837-52.0.tree,NEW
4,0,0,22,26,21,COIL20_new/COIL20_run_19/COIL20-0.030594306580221553-72.0.tree,NEW
9,2,0,26,37,25,COIL20_new/COIL20_run_19/COIL20-0.02731643332215483-2148.0.tree,NEW
2,1,2,23,28,23,COIL20_new/COIL20_run_19/COIL20-0.04387700042849674-50.0.tree,NEW
1,0,0,5,6,5,COIL20_new/COIL20_run_19/COIL20-0.11951332997987907-12.0.tree,NEW
2,0,0,14,16,14,COIL20_new/COIL20_run_19/COIL20-0.05042331535509309-32.0.tree,NEW
4,0,0,21,25,19,COIL20_new/COIL20_run_19/COIL20-0.03707552025113703-70.0.tree,NEW
2,1,2,22,27,22,COIL20_new/COIL20_run_19/COIL20-0.0463050408935099-48.0.tree,NEW
2,0,0,13,15,13,COIL20_new/COIL20_run_19/COIL20-0.055148751304121724-30.0.tree,NEW
3,0,0,19,22,18,COIL20_new/COIL20_run_19/COIL20-0.04238842778895535-54.0.tree,NEW
2,0,0,9,11,9,COIL20_new/COIL20_run_19/COIL20-0.08796327734928117-22.0.tree,NEW
4,1,0,23,28,23,COIL20_new/COIL20_run_19/COIL20-0.030467923280423526-74.0.tree,NEW
9,1,0,25,35,25,COIL20_new/COIL20_run_19/COIL20-0.02766933778597408-164.0.tree,NEW
0,0,0,7,7,7,COIL20_new/COIL20_run_19/COIL20-0.11394804009240667-14.0.tree,NEW
2,0,0,10,12,10,COIL20_new/COIL20_run_19/COIL20-0.08188421035472115-24.0.tree,NEW
7,2,0,26,35,25,COIL20_new/COIL20_run_19/COIL20-0.02752149470899473-2134.0.tree,NEW
7,1,0,25,33,25,COIL20_new/COIL20_run_19/COIL20-0.027857818205529072-150.0.tree,NEW
1,0,0,9,10,9,COIL20_new/COIL20_run_19/COIL20-0.09615747727103385-20.0.tree,NEW
1,0,0,3,4,3,COIL20_new/COIL20_run_19/COIL20-0.15407019664282018-8.0.tree,NEW
1,1,2,22,26,21,COIL20_new/COIL20_run_19/COIL20-0.048384729674342486-46.0.tree,NEW
0,0,0,2,2,2,COIL20_new/COIL20_run_19/COIL20-0.17269562979730224-4.0.tree,NEW
3,0,0,21,24,20,COIL20_new/COIL20_run_19/COIL20-0.0371922041508298-58.0.tree,NEW
1,0,0,13,14,13,COIL20_new/COIL20_run_19/COIL20-0.07101904249571545-28.0.tree,NEW
0,0,0,1,1,1,COIL20_new/COIL20_run_19/COIL20-1.1240121283255067-2.0.tree,NEW
6,1,0,24,31,23,COIL20_new/COIL20_run_19/COIL20-0.028451100119233685-136.0.tree,NEW
3,0,0,20,23,19,COIL20_new/COIL20_run_19/COIL20-0.0382331954691113-56.0.tree,NEW
2,0,0,6,8,6,COIL20_new/COIL20_run_19/COIL20-0.09903823403383238-16.0.tree,NEW
0,0,0,5,5,5,COIL20_new/COIL20_run_19/COIL20-0.12943930946791876-10.0.tree,NEW
10,2,0,26,38,25,COIL20_new/COIL20_run_19/COIL20-0.02724018881809409-2160.0.tree,NEW
6,0,0,23,29,21,COIL20_new/COIL20_run_19/COIL20-0.029334723619495018-88.0.tree,NEW
7,1,0,24,32,24,COIL20_new/COIL20_run_19/COIL20-0.028321712683508637-148.0.tree,NEW
8,1,0,25,34,25,COIL20_new/COIL20_run_19/COIL20-0.027693289365823714-162.0.tree,NEW
8,2,0,26,36,25,COIL20_new/COIL20_run_19/COIL20-0.027373104366943124-2136.0.tree,NEW
1,0,0,8,9,8,COIL20_new/COIL20_run_19/COIL20-0.0967287404985463-18.0.tree,NEW
1,0,0,12,13,12,COIL20_new/COIL20_run_19/COIL20-0.0787724262240112-26.0.tree,NEW
1,0,1,16,18,15,COIL20_new/COIL20_run_27/COIL20-0.05896557586258144-44.0.tree,NEW
1,0,1,21,23,20,COIL20_new/COIL20_run_27/COIL20-0.04335281364110588-54.0.tree,NEW
0,0,0,3,3,3,COIL20_new/COIL20_run_27/COIL20-0.15964352084730588-6.0.tree,NEW
6,0,2,27,35,26,COIL20_new/COIL20_run_27/COIL20-0.029138686284373216-162.0.tree,NEW
7,0,2,27,36,26,COIL20_new/COIL20_run_27/COIL20-0.02806155218347195-164.0.tree,NEW
5,0,2,25,32,24,COIL20_new/COIL20_run_27/COIL20-0.030274494187346013-136.0.tree,NEW
0,0,0,4,4,4,COIL20_new/COIL20_run_27/COIL20-0.14053578414934043-8.0.tree,NEW
1,0,0,4,5,4,COIL20_new/COIL20_run_27/COIL20-0.12824855382293704-10.0.tree,NEW
10,1,5,32,48,30,COIL20_new/COIL20_run_27/COIL20-0.025175532360830977-66658.0.tree,NEW
0,0,1,9,10,9,COIL20_new/COIL20_run_27/COIL20-0.09060407584395236-18.0.tree,NEW
2,0,1,23,26,21,COIL20_new/COIL20_run_27/COIL20-0.03585809998882128-70.0.tree,NEW
1,0,1,13,15,13,COIL20_new/COIL20_run_27/COIL20-0.06769197360086465-38.0.tree,NEW
3,0,1,23,27,23,COIL20_new/COIL20_run_27/COIL20-0.03337485561517295-72.0.tree,NEW
0,0,1,11,12,11,COIL20_new/COIL20_run_27/COIL20-0.07405778420523162-22.0.tree,NEW
1,0,1,14,16,14,COIL20_new/COIL20_run_27/COIL20-0.06476992743498061-40.0.tree,NEW
1,0,1,17,19,16,COIL20_new/COIL20_run_27/COIL20-0.0526256497317234-46.0.tree,NEW
1,0,1,20,22,19,COIL20_new/COIL20_run_27/COIL20-0.044185029156420086-52.0.tree,NEW
9,0,3,29,41,28,COIL20_new/COIL20_run_27/COIL20-0.025233798625083848-418.0.tree,NEW
1,0,0,5,6,5,COIL20_new/COIL20_run_27/COIL20-0.1033616164580079-12.0.tree,NEW
1,1,1,22,25,22,COIL20_new/COIL20_run_27/COIL20-0.03786217303822981-56.0.tree,NEW
0,0,0,2,2,2,COIL20_new/COIL20_run_27/COIL20-0.17945306095834285-4.0.tree,NEW
1,0,1,18,20,18,COIL20_new/COIL20_run_27/COIL20-0.051976605000372045-48.0.tree,NEW
8,0,2,28,38,27,COIL20_new/COIL20_run_27/COIL20-0.025692232096281464-178.0.tree,NEW
4,0,2,25,31,25,COIL20_new/COIL20_run_27/COIL20-0.030378567702511405-134.0.tree,NEW
8,0,3,29,40,29,COIL20_new/COIL20_run_27/COIL20-0.025339397496088212-226.0.tree,NEW
0,0,1,10,11,10,COIL20_new/COIL20_run_27/COIL20-0.08320399247335802-20.0.tree,NEW
4,0,1,24,29,24,COIL20_new/COIL20_run_27/COIL20-0.03062831852224429-86.0.tree,NEW
1,0,1,19,21,18,COIL20_new/COIL20_run_27/COIL20-0.04837561247112282-50.0.tree,NEW
2,0,1,22,25,21,COIL20_new/COIL20_run_27/COIL20-0.03629645931142317-58.0.tree,NEW
0,0,0,1,1,1,COIL20_new/COIL20_run_27/COIL20-0.2649359234108355-2.0.tree,NEW
1,0,1,15,17,14,COIL20_new/COIL20_run_27/COIL20-0.06101348833743231-42.0.tree,NEW
0,0,1,8,9,8,COIL20_new/COIL20_run_27/COIL20-0.0994585452529998-16.0.tree,NEW
0,0,1,6,7,6,COIL20_new/COIL20_run_18/COIL20-0.14507109788359734-12.0.tree,NEW
0,0,0,2,2,2,COIL20_new/COIL20_run_18/COIL20-0.21948390574931048-4.0.tree,NEW
1,0,4,18,23,16,COIL20_new/COIL20_run_18/COIL20-0.05968109583426512-39.0.tree,NEW
2,0,6,26,34,24,COIL20_new/COIL20_run_18/COIL20-0.037017440289886794-60.0.tree,NEW
13,4,13,40,70,32,COIL20_new/COIL20_run_18/COIL20-0.027612550301810757-963.5.tree,NEW
0,0,0,3,3,3,COIL20_new/COIL20_run_18/COIL20-0.156994082550861-6.0.tree,NEW
1,0,4,24,29,22,COIL20_new/COIL20_run_18/COIL20-0.04170838689544615-51.0.tree,NEW
3,0,5,26,34,25,COIL20_new/COIL20_run_18/COIL20-0.033015011364482094-68.0.tree,NEW
1,0,1,14,16,14,COIL20_new/COIL20_run_18/COIL20-0.07106746963261024-30.0.tree,NEW
8,5,7,35,55,30,COIL20_new/COIL20_run_18/COIL20-0.028332786068261284-266.0.tree,NEW
0,0,1,9,10,9,COIL20_new/COIL20_run_18/COIL20-0.12553840403532268-18.0.tree,NEW
1,0,1,13,15,13,COIL20_new/COIL20_run_18/COIL20-0.07778603332960748-28.0.tree,NEW
13,3,13,39,68,32,COIL20_new/COIL20_run_18/COIL20-0.027279359024517447-1714.0.tree,NEW
3,1,6,28,38,26,COIL20_new/COIL20_run_18/COIL20-0.03198024955287354-74.0.tree,NEW
1,0,2,15,18,13,COIL20_new/COIL20_run_18/COIL20-0.06997306757209948-33.0.tree,NEW
3,0,4,25,32,24,COIL20_new/COIL20_run_18/COIL20-0.03419878064684512-66.0.tree,NEW
1,0,1,12,14,12,COIL20_new/COIL20_run_18/COIL20-0.08267158506595212-26.0.tree,NEW
11,4,12,38,65,29,COIL20_new/COIL20_run_18/COIL20-0.028118677341829268-409.0.tree,NEW
5,2,5,29,41,26,COIL20_new/COIL20_run_18/COIL20-0.031038091977792392-90.0.tree,NEW
1,0,3,21,25,20,COIL20_new/COIL20_run_18/COIL20-0.0527620933936957-44.0.tree,NEW
1,0,4,23,28,21,COIL20_new/COIL20_run_18/COIL20-0.04388321829122882-49.0.tree,NEW
10,3,11,37,61,32,COIL20_new/COIL20_run_18/COIL20-0.02810875670690821-502.0.tree,NEW
1,0,1,16,18,16,COIL20_new/COIL20_run_18/COIL20-0.06464956405097283-34.0.tree,NEW
12,4,13,40,69,34,COIL20_new/COIL20_run_18/COIL20-0.027901261737089622-867.5.tree,NEW
0,0,1,10,11,10,COIL20_new/COIL20_run_18/COIL20-0.09051886550786153-20.0.tree,NEW
1,0,4,20,25,18,COIL20_new/COIL20_run_18/COIL20-0.05670645400178875-43.0.tree,NEW
12,4,13,40,69,33,COIL20_new/COIL20_run_18/COIL20-0.027841807791191386-959.5.tree,NEW
3,1,7,29,40,26,COIL20_new/COIL20_run_18/COIL20-0.031859094381101405-79.0.tree,NEW
8,3,8,33,52,31,COIL20_new/COIL20_run_18/COIL20-0.028669423951114215-128.0.tree,NEW
4,1,6,29,40,26,COIL20_new/COIL20_run_18/COIL20-0.031665467341083775-88.0.tree,NEW
0,0,4,22,26,18,COIL20_new/COIL20_run_18/COIL20-0.05242110067814271-45.0.tree,NEW
2,1,4,25,32,24,COIL20_new/COIL20_run_18/COIL20-0.03742140342052308-55.0.tree,NEW
1,0,4,19,24,17,COIL20_new/COIL20_run_18/COIL20-0.05790987825098748-41.0.tree,NEW
1,0,3,22,26,22,COIL20_new/COIL20_run_18/COIL20-0.044736323030777125-46.0.tree,NEW
1,0,3,18,22,17,COIL20_new/COIL20_run_18/COIL20-0.06261746404352087-38.0.tree,NEW
3,2,5,28,38,26,COIL20_new/COIL20_run_18/COIL20-0.03190339956405064-78.0.tree,NEW
7,6,9,37,59,34,COIL20_new/COIL20_run_18/COIL20-0.028577460131157584-259.0.tree,NEW
4,0,2,23,29,22,COIL20_new/COIL20_run_20/COIL20-0.037269240442655394-64.0.tree,NEW
4,1,3,26,34,22,COIL20_new/COIL20_run_20/COIL20-0.034780290539533965-81.0.tree,NEW
0,0,0,3,3,3,COIL20_new/COIL20_run_20/COIL20-0.167801822509129-6.0.tree,NEW
0,0,1,17,18,17,COIL20_new/COIL20_run_20/COIL20-0.04644034344958625-34.0.tree,NEW
4,1,3,25,33,22,COIL20_new/COIL20_run_20/COIL20-0.03500168837096679-70.0.tree,NEW
14,5,13,43,75,35,COIL20_new/COIL20_run_20/COIL20-0.025464406811238016-907.0.tree,NEW
0,0,0,8,8,8,COIL20_new/COIL20_run_20/COIL20-0.09117070478426098-16.0.tree,NEW
14,4,12,42,72,34,COIL20_new/COIL20_run_20/COIL20-0.025798261792980448-867.0.tree,NEW
13,5,11,40,69,33,COIL20_new/COIL20_run_20/COIL20-0.02607197583650034-623.0.tree,NEW
7,2,6,30,45,26,COIL20_new/COIL20_run_20/COIL20-0.028851535136746265-114.0.tree,NEW
0,0,1,18,19,18,COIL20_new/COIL20_run_20/COIL20-0.04361748034503388-36.0.tree,NEW
0,0,1,19,20,19,COIL20_new/COIL20_run_20/COIL20-0.04127412623891463-38.0.tree,NEW
5,0,3,24,32,22,COIL20_new/COIL20_run_20/COIL20-0.03498305807064528-79.0.tree,NEW
12,4,9,37,62,32,COIL20_new/COIL20_run_20/COIL20-0.02606162437588544-693.0.tree,NEW
0,0,0,5,5,5,COIL20_new/COIL20_run_20/COIL20-0.1367784601125267-10.0.tree,NEW
0,0,0,7,7,7,COIL20_new/COIL20_run_20/COIL20-0.0980951565876742-14.0.tree,NEW
0,0,0,2,2,2,COIL20_new/COIL20_run_20/COIL20-0.205864585662121-4.0.tree,NEW
13,4,11,40,68,32,COIL20_new/COIL20_run_20/COIL20-0.02586133700350185-836.0.tree,NEW
0,0,0,6,6,6,COIL20_new/COIL20_run_20/COIL20-0.12207970042477073-12.0.tree,NEW
0,0,1,21,22,21,COIL20_new/COIL20_run_20/COIL20-0.03957917644757358-42.0.tree,NEW
6,4,7,33,50,30,COIL20_new/COIL20_run_20/COIL20-0.02790556999403704-134.0.tree,NEW
2,1,1,23,27,21,COIL20_new/COIL20_run_20/COIL20-0.03769999627394072-61.0.tree,NEW
0,0,1,20,21,20,COIL20_new/COIL20_run_20/COIL20-0.04127359061778019-40.0.tree,NEW
15,5,14,44,78,32,COIL20_new/COIL20_run_20/COIL20-0.025388185595052126-141023.0.tree,NEW
0,0,0,9,9,9,COIL20_new/COIL20_run_20/COIL20-0.07858139578209922-18.0.tree,NEW
4,1,3,26,34,23,COIL20_new/COIL20_run_20/COIL20-0.03351075201207249-82.0.tree,NEW
19,4,14,43,80,34,COIL20_new/COIL20_run_20/COIL20-0.025323235710559333-598759.0.tree,NEW
6,1,3,26,36,24,COIL20_new/COIL20_run_20/COIL20-0.03166478034875969-86.0.tree,NEW
0,0,0,4,4,4,COIL20_new/COIL20_run_20/COIL20-0.14695336370072304-8.0.tree,NEW
10,3,8,34,55,29,COIL20_new/COIL20_run_20/COIL20-0.027030330128921365-229.0.tree,NEW
12,5,10,38,65,31,COIL20_new/COIL20_run_20/COIL20-0.026076761494895018-424.0.tree,NEW
5,5,5,31,46,28,COIL20_new/COIL20_run_20/COIL20-0.02939904473135141-91.0.tree,NEW
0,0,0,1,1,1,COIL20_new/COIL20_run_20/COIL20-0.24280184579700415-2.0.tree,NEW
2,0,1,22,25,21,COIL20_new/COIL20_run_20/COIL20-0.037783716186005234-58.0.tree,NEW
0,0,0,13,13,13,COIL20_new/COIL20_run_20/COIL20-0.06762732645875225-26.0.tree,NEW
6,3,6,31,46,27,COIL20_new/COIL20_run_20/COIL20-0.029178753073999697-113.0.tree,NEW
12,4,9,37,62,30,COIL20_new/COIL20_run_20/COIL20-0.02655070469111015-398.0.tree,NEW
9,1,6,30,46,26,COIL20_new/COIL20_run_29/COIL20-0.0254177844846864-459.0.tree,NEW
0,0,0,1,1,1,COIL20_new/COIL20_run_29/COIL20-1.1826095461658817-2.0.tree,NEW
1,0,0,11,12,11,COIL20_new/COIL20_run_29/COIL20-0.06782669396005697-24.0.tree,NEW
1,0,0,10,11,10,COIL20_new/COIL20_run_29/COIL20-0.0724958547581781-22.0.tree,NEW
9,1,5,29,44,27,COIL20_new/COIL20_run_29/COIL20-0.02543391133839995-291.0.tree,NEW
10,1,9,33,53,29,COIL20_new/COIL20_run_29/COIL20-0.024988507433489515-2455.25.tree,NEW
10,1,11,35,57,29,COIL20_new/COIL20_run_29/COIL20-0.024877901669274893-8034.0.tree,NEW
1,0,0,4,5,4,COIL20_new/COIL20_run_29/COIL20-0.14133238085922945-10.0.tree,NEW
9,1,10,34,54,28,COIL20_new/COIL20_run_29/COIL20-0.024980065578656174-4455.25.tree,NEW
1,0,0,9,10,9,COIL20_new/COIL20_run_29/COIL20-0.07882775821596266-20.0.tree,NEW
3,1,1,23,28,22,COIL20_new/COIL20_run_29/COIL20-0.030972257154035843-71.0.tree,NEW
1,0,0,8,9,8,COIL20_new/COIL20_run_29/COIL20-0.08411239427304584-18.0.tree,NEW
1,0,0,18,19,18,COIL20_new/COIL20_run_29/COIL20-0.036737438520008436-38.0.tree,NEW
4,1,3,25,33,25,COIL20_new/COIL20_run_29/COIL20-0.028801780590952564-117.0.tree,NEW
0,0,0,7,7,7,COIL20_new/COIL20_run_29/COIL20-0.1036254913741721-14.0.tree,NEW
10,2,10,35,57,30,COIL20_new/COIL20_run_29/COIL20-0.024960480475444857-4505.25.tree,NEW
9,1,7,31,48,29,COIL20_new/COIL20_run_29/COIL20-0.025297688911245175-507.0.tree,NEW
0,0,1,4,5,4,COIL20_new/COIL20_run_29/COIL20-0.17934026613384008-8.0.tree,NEW
2,1,0,22,25,21,COIL20_new/COIL20_run_29/COIL20-0.03146764848349304-58.0.tree,NEW
1,0,0,12,13,12,COIL20_new/COIL20_run_29/COIL20-0.06448323040092341-26.0.tree,NEW
3,1,2,24,30,24,COIL20_new/COIL20_run_29/COIL20-0.030336230345032467-85.0.tree,NEW
2,0,0,19,21,19,COIL20_new/COIL20_run_29/COIL20-0.03378305713913071-42.0.tree,NEW
0,0,0,2,2,2,COIL20_new/COIL20_run_29/COIL20-0.2390068536217302-4.0.tree,NEW
3,1,2,24,30,23,COIL20_new/COIL20_run_29/COIL20-0.03084252040017904-75.0.tree,NEW
2,0,0,20,22,20,COIL20_new/COIL20_run_29/COIL20-0.033428499236156484-44.0.tree,NEW
10,3,12,38,63,31,COIL20_new/COIL20_run_29/COIL20-0.024809004489902364-15964.75.tree,NEW
2,0,0,21,23,20,COIL20_new/COIL20_run_29/COIL20-0.03190553040465077-56.0.tree,NEW
4,1,2,24,31,24,COIL20_new/COIL20_run_29/COIL20-0.03029409093449592-93.0.tree,NEW
6,1,3,27,37,26,COIL20_new/COIL20_run_29/COIL20-0.02591820599523137-139.0.tree,NEW
9,1,8,32,50,29,COIL20_new/COIL20_run_29/COIL20-0.025048159326327535-1051.0.tree,NEW
1,0,0,5,6,5,COIL20_new/COIL20_run_29/COIL20-0.10936183070646172-12.0.tree,NEW
1,0,0,7,8,7,COIL20_new/COIL20_run_29/COIL20-0.0906078950555178-16.0.tree,NEW
10,1,11,35,57,28,COIL20_new/COIL20_run_29/COIL20-0.02488255924435473-6333.25.tree,NEW
10,1,7,31,49,27,COIL20_new/COIL20_run_29/COIL20-0.025275972967433558-831.25.tree,NEW
0,0,0,3,3,3,COIL20_new/COIL20_run_29/COIL20-0.210067220452344-6.0.tree,NEW
10,2,11,36,59,30,COIL20_new/COIL20_run_29/COIL20-0.02486838857217316-8082.0.tree,NEW
2,1,1,23,27,22,COIL20_new/COIL20_run_29/COIL20-0.031056000353976043-63.0.tree,NEW
9,1,7,31,48,28,COIL20_new/COIL20_run_29/COIL20-0.025176696754600825-835.0.tree,NEW
3,1,3,25,32,25,COIL20_new/COIL20_run_29/COIL20-0.028581721812355854-133.0.tree,NEW
10,1,10,34,55,29,COIL20_new/COIL20_run_29/COIL20-0.024972997708472333-4457.25.tree,NEW
0,0,0,2,2,2,COIL20_new/COIL20_run_1/COIL20-0.16835530544377397-4.0.tree,NEW
19,9,13,43,84,30,COIL20_new/COIL20_run_1/COIL20-0.026458391553021154-157164.0.tree,NEW
16,4,10,35,65,27,COIL20_new/COIL20_run_1/COIL20-0.02724386830240788-635.75.tree,NEW
20,6,10,37,73,29,COIL20_new/COIL20_run_1/COIL20-0.0267268891124523-1998.0.tree,NEW
0,0,0,8,8,8,COIL20_new/COIL20_run_1/COIL20-0.0795585201020953-16.0.tree,NEW
7,4,3,27,41,24,COIL20_new/COIL20_run_1/COIL20-0.032828242603770486-81.0.tree,NEW
20,7,10,38,75,27,COIL20_new/COIL20_run_1/COIL20-0.026483833556896208-2393.0.tree,NEW
8,4,4,28,44,24,COIL20_new/COIL20_run_1/COIL20-0.032526548177956804-88.0.tree,NEW
0,0,0,9,9,9,COIL20_new/COIL20_run_1/COIL20-0.0759506460056632-18.0.tree,NEW
6,2,3,25,36,23,COIL20_new/COIL20_run_1/COIL20-0.03397089714211099-64.0.tree,NEW
6,2,2,24,34,22,COIL20_new/COIL20_run_1/COIL20-0.03428368824055433-63.0.tree,NEW
7,2,3,25,37,23,COIL20_new/COIL20_run_1/COIL20-0.033218128213726605-68.0.tree,NEW
4,2,2,24,32,22,COIL20_new/COIL20_run_1/COIL20-0.037580773995827266-56.0.tree,NEW
8,4,4,28,44,23,COIL20_new/COIL20_run_1/COIL20-0.032459595536179664-92.0.tree,NEW
15,4,9,34,62,27,COIL20_new/COIL20_run_1/COIL20-0.027320112806469288-446.75.tree,NEW
6,3,3,26,38,24,COIL20_new/COIL20_run_1/COIL20-0.03331405097250184-67.0.tree,NEW
9,4,6,30,49,25,COIL20_new/COIL20_run_1/COIL20-0.03144381334302143-122.0.tree,NEW
7,3,3,26,39,23,COIL20_new/COIL20_run_1/COIL20-0.03317919088605681-71.0.tree,NEW
12,4,7,32,55,25,COIL20_new/COIL20_run_1/COIL20-0.02807673587823284-170.0.tree,NEW
0,0,0,3,3,3,COIL20_new/COIL20_run_1/COIL20-0.1428649442954017-6.0.tree,NEW
0,0,0,6,6,6,COIL20_new/COIL20_run_1/COIL20-0.08877626872345218-12.0.tree,NEW
0,0,0,5,5,5,COIL20_new/COIL20_run_1/COIL20-0.10604116597734536-10.0.tree,NEW
17,4,8,33,62,26,COIL20_new/COIL20_run_1/COIL20-0.027346346598107696-366.25.tree,NEW
7,4,4,28,43,24,COIL20_new/COIL20_run_1/COIL20-0.03302543268872482-80.0.tree,NEW
9,4,5,29,47,24,COIL20_new/COIL20_run_1/COIL20-0.03192349700052183-103.0.tree,NEW
7,4,3,27,41,25,COIL20_new/COIL20_run_1/COIL20-0.032027337636933884-95.0.tree,NEW
0,0,0,4,4,4,COIL20_new/COIL20_run_1/COIL20-0.12358736912213991-8.0.tree,NEW
2,2,2,24,30,22,COIL20_new/COIL20_run_1/COIL20-0.03955791461733382-52.0.tree,NEW
4,2,2,24,32,23,COIL20_new/COIL20_run_1/COIL20-0.03586321167747197-57.0.tree,NEW
0,0,0,10,10,10,COIL20_new/COIL20_run_1/COIL20-0.07113701887249396-20.0.tree,NEW
5,2,2,24,33,23,COIL20_new/COIL20_run_1/COIL20-0.03444911366346193-61.0.tree,NEW
3,1,1,20,25,20,COIL20_new/COIL20_run_1/COIL20-0.058155903010657206-46.0.tree,NEW
8,2,4,26,40,23,COIL20_new/COIL20_run_1/COIL20-0.03306945841717002-75.0.tree,NEW
14,4,7,32,57,25,COIL20_new/COIL20_run_1/COIL20-0.027911298811387153-194.0.tree,NEW
0,0,0,7,7,7,COIL20_new/COIL20_run_1/COIL20-0.0847967317795662-14.0.tree,NEW
2,2,2,23,29,21,COIL20_new/COIL20_run_1/COIL20-0.0443110864259631-50.0.tree,NEW
20,6,9,36,71,27,COIL20_new/COIL20_run_1/COIL20-0.027022633486101455-1049.25.tree,NEW
16,7,9,37,69,29,COIL20_new/COIL20_run_1/COIL20-0.026769890174379973-1812.0.tree,NEW
19,6,9,36,70,28,COIL20_new/COIL20_run_1/COIL20-0.026826281764661286-1625.25.tree,NEW
18,9,13,43,83,30,COIL20_new/COIL20_run_1/COIL20-0.026482867110067976-157152.0.tree,NEW
0,0,0,1,1,1,COIL20_new/COIL20_run_1/COIL20-0.2962589891199048-2.0.tree,NEW
13,4,6,31,54,26,COIL20_new/COIL20_run_1/COIL20-0.027370612564274366-215.0.tree,NEW
2,2,2,22,28,20,COIL20_new/COIL20_run_1/COIL20-0.04650097343319248-48.0.tree,NEW
10,4,5,29,48,25,COIL20_new/COIL20_run_1/COIL20-0.03168458668678742-115.0.tree,NEW
5,2,2,24,33,23,COIL20_new/COIL20_run_1/COIL20-0.03540551177434942-59.0.tree,NEW
1,0,4,25,30,25,COIL20_new/COIL20_run_6/COIL20-0.03589986679335311-62.0.tree,NEW
0,0,0,4,4,4,COIL20_new/COIL20_run_6/COIL20-0.15044843132871316-8.0.tree,NEW
7,0,8,33,48,31,COIL20_new/COIL20_run_6/COIL20-0.02635260637901482-504.0.tree,NEW
0,0,1,6,7,6,COIL20_new/COIL20_run_6/COIL20-0.13961800897980453-12.0.tree,NEW
0,0,1,15,16,14,COIL20_new/COIL20_run_6/COIL20-0.08316984080408368-30.0.tree,NEW
3,1,4,28,36,27,COIL20_new/COIL20_run_6/COIL20-0.031114196754601975-139.0.tree,NEW
0,0,0,5,5,5,COIL20_new/COIL20_run_6/COIL20-0.14478464537223323-10.0.tree,NEW
0,0,1,17,18,16,COIL20_new/COIL20_run_6/COIL20-0.07163330678515573-34.0.tree,NEW
5,0,6,30,41,27,COIL20_new/COIL20_run_6/COIL20-0.02815334134436298-213.0.tree,NEW
6,0,9,34,49,31,COIL20_new/COIL20_run_6/COIL20-0.02636242221849666-325.0.tree,NEW
7,3,12,40,62,32,COIL20_new/COIL20_run_6/COIL20-0.025675965515313925-19013.0.tree,NEW
7,2,11,38,58,31,COIL20_new/COIL20_run_6/COIL20-0.025774065690439107-1719.0.tree,NEW
8,1,10,36,55,30,COIL20_new/COIL20_run_6/COIL20-0.025930699940383217-1106.0.tree,NEW
3,0,5,28,36,27,COIL20_new/COIL20_run_6/COIL20-0.031154042309412655-138.0.tree,NEW
4,0,10,31,45,28,COIL20_new/COIL20_run_6/COIL20-0.03250925693047174-132.0.tree,NEW
0,0,0,3,3,3,COIL20_new/COIL20_run_6/COIL20-0.1625927672516581-6.0.tree,NEW
0,0,0,2,2,2,COIL20_new/COIL20_run_6/COIL20-0.17576430807064602-4.0.tree,NEW
6,2,11,38,57,31,COIL20_new/COIL20_run_6/COIL20-0.025878267288918733-1127.0.tree,NEW
7,4,12,41,64,34,COIL20_new/COIL20_run_6/COIL20-0.025574150924063566-19127.0.tree,NEW
0,0,0,8,8,8,COIL20_new/COIL20_run_6/COIL20-0.12091390938221941-16.0.tree,NEW
6,1,9,35,51,31,COIL20_new/COIL20_run_6/COIL20-0.02604281941649994-773.0.tree,NEW
3,0,4,27,34,26,COIL20_new/COIL20_run_6/COIL20-0.03119874338624351-136.0.tree,NEW
2,0,4,26,32,26,COIL20_new/COIL20_run_6/COIL20-0.03251837413369091-122.0.tree,NEW
0,0,1,18,19,18,COIL20_new/COIL20_run_6/COIL20-0.06265470135628548-36.0.tree,NEW
1,1,5,26,33,25,COIL20_new/COIL20_run_6/COIL20-0.04045511494895282-55.0.tree,NEW
1,0,0,6,7,6,COIL20_new/COIL20_run_6/COIL20-0.1299608996572021-14.0.tree,NEW
4,0,5,29,38,28,COIL20_new/COIL20_run_6/COIL20-0.030430651035844136-199.0.tree,NEW
5,0,8,32,45,29,COIL20_new/COIL20_run_6/COIL20-0.027794614911692384-263.0.tree,NEW
0,0,0,1,1,1,COIL20_new/COIL20_run_6/COIL20-0.24890337394738843-2.0.tree,NEW
6,0,8,33,47,30,COIL20_new/COIL20_run_6/COIL20-0.026416112415232507-312.0.tree,NEW
5,0,5,29,39,26,COIL20_new/COIL20_run_6/COIL20-0.02876298299053609-200.0.tree,NEW
0,0,2,21,23,21,COIL20_new/COIL20_run_6/COIL20-0.048873332588121265-42.0.tree,NEW
0,0,2,20,22,20,COIL20_new/COIL20_run_6/COIL20-0.05431753716744886-40.0.tree,NEW
3,0,8,29,40,25,COIL20_new/COIL20_run_6/COIL20-0.03369395772784878-77.0.tree,NEW
2,0,3,25,30,24,COIL20_new/COIL20_run_6/COIL20-0.03486224057306936-74.0.tree,NEW
8,2,11,38,59,33,COIL20_new/COIL20_run_6/COIL20-0.0257310180527614-3447.0.tree,NEW
5,1,6,31,43,29,COIL20_new/COIL20_run_6/COIL20-0.027905861092482165-261.0.tree,NEW
7,0,9,34,50,30,COIL20_new/COIL20_run_6/COIL20-0.02604647561293716-517.0.tree,NEW
0,0,2,22,24,22,COIL20_new/COIL20_run_6/COIL20-0.04143287968552095-44.0.tree,NEW
0,0,0,2,2,2,COIL20_new/COIL20_run_25/COIL20-0.1866774838847906-4.0.tree,NEW
4,1,1,22,28,21,COIL20_new/COIL20_run_25/COIL20-0.03601224243609741-52.0.tree,NEW
0,0,0,7,7,7,COIL20_new/COIL20_run_25/COIL20-0.10013194910201872-14.0.tree,NEW
4,0,3,23,30,22,COIL20_new/COIL20_run_25/COIL20-0.03534372904091154-55.0.tree,NEW
6,0,10,30,46,28,COIL20_new/COIL20_run_25/COIL20-0.028540106379015384-332.0.tree,NEW
1,0,0,10,11,10,COIL20_new/COIL20_run_25/COIL20-0.0912769906475896-22.0.tree,NEW
2,0,0,14,16,14,COIL20_new/COIL20_run_25/COIL20-0.062231420933005654-32.0.tree,NEW
5,0,3,23,31,22,COIL20_new/COIL20_run_25/COIL20-0.03365485738505125-57.0.tree,NEW
4,0,1,21,26,21,COIL20_new/COIL20_run_25/COIL20-0.036187017940979005-50.0.tree,NEW
1,0,0,9,10,9,COIL20_new/COIL20_run_25/COIL20-0.09294809365452-20.0.tree,NEW
2,0,0,11,13,11,COIL20_new/COIL20_run_25/COIL20-0.0692171664244729-26.0.tree,NEW
6,0,5,25,36,24,COIL20_new/COIL20_run_25/COIL20-0.029331323589686764-63.0.tree,NEW
6,0,11,31,48,27,COIL20_new/COIL20_run_25/COIL20-0.02844206442357755-446.0.tree,NEW
2,0,1,17,20,17,COIL20_new/COIL20_run_25/COIL20-0.05316874627394019-38.0.tree,NEW
6,0,6,26,38,24,COIL20_new/COIL20_run_25/COIL20-0.02930495007079592-76.0.tree,NEW
5,1,1,22,29,21,COIL20_new/COIL20_run_25/COIL20-0.03580983586705416-54.0.tree,NEW
2,0,0,12,14,12,COIL20_new/COIL20_run_25/COIL20-0.06482810054773164-28.0.tree,NEW
0,0,0,1,1,1,COIL20_new/COIL20_run_25/COIL20-0.26185724299500734-2.0.tree,NEW
0,0,0,5,5,5,COIL20_new/COIL20_run_25/COIL20-0.12678647114166453-10.0.tree,NEW
0,0,0,3,3,3,COIL20_new/COIL20_run_25/COIL20-0.15683804214173874-6.0.tree,NEW
6,0,10,30,46,27,COIL20_new/COIL20_run_25/COIL20-0.028430175963185977-4163.0.tree,NEW
6,0,3,23,32,22,COIL20_new/COIL20_run_25/COIL20-0.0318951905879713-59.0.tree,NEW
6,0,4,24,34,23,COIL20_new/COIL20_run_25/COIL20-0.03009588782696232-61.0.tree,NEW
2,0,0,16,18,16,COIL20_new/COIL20_run_25/COIL20-0.056826398204038564-36.0.tree,NEW
7,0,10,30,47,27,COIL20_new/COIL20_run_25/COIL20-0.028278210932260184-4165.0.tree,NEW
2,0,0,10,12,10,COIL20_new/COIL20_run_25/COIL20-0.0777700462031447-24.0.tree,NEW
6,0,7,27,40,26,COIL20_new/COIL20_run_25/COIL20-0.029162928962665313-87.0.tree,NEW
0,0,0,4,4,4,COIL20_new/COIL20_run_25/COIL20-0.13219234387808365-8.0.tree,NEW
6,0,12,32,50,29,COIL20_new/COIL20_run_25/COIL20-0.02844171510544824-578.0.tree,NEW
2,0,1,18,21,18,COIL20_new/COIL20_run_25/COIL20-0.05252605913257341-40.0.tree,NEW
0,0,0,6,6,6,COIL20_new/COIL20_run_25/COIL20-0.11554391161785466-12.0.tree,NEW
3,0,1,21,25,21,COIL20_new/COIL20_run_25/COIL20-0.03674380775393077-48.0.tree,NEW
2,0,0,15,17,15,COIL20_new/COIL20_run_25/COIL20-0.06193983344511589-34.0.tree,NEW
7,0,12,32,51,28,COIL20_new/COIL20_run_25/COIL20-0.028169258607198322-4292.0.tree,NEW
2,0,1,19,22,19,COIL20_new/COIL20_run_25/COIL20-0.04060911766897696-42.0.tree,NEW
6,0,8,28,42,27,COIL20_new/COIL20_run_25/COIL20-0.0287736488374693-89.0.tree,NEW
0,0,0,6,6,6,COIL20_new/COIL20_run_22/COIL20-0.1162012701207249-12.0.tree,NEW
8,2,7,32,49,28,COIL20_new/COIL20_run_22/COIL20-0.026131068820329506-4311.0.tree,NEW
1,0,0,19,20,19,COIL20_new/COIL20_run_22/COIL20-0.03873214984350426-40.0.tree,NEW
1,0,0,13,14,13,COIL20_new/COIL20_run_22/COIL20-0.06282833575527247-28.0.tree,NEW
0,0,0,1,1,1,COIL20_new/COIL20_run_22/COIL20-1.1229851330203422-2.0.tree,NEW
0,0,1,3,4,3,COIL20_new/COIL20_run_22/COIL20-0.166358742734183-6.0.tree,NEW
0,0,0,7,7,7,COIL20_new/COIL20_run_22/COIL20-0.10799612489753341-14.0.tree,NEW
0,1,0,11,12,9,COIL20_new/COIL20_run_22/COIL20-0.08334012174901262-22.0.tree,NEW
7,2,7,32,48,27,COIL20_new/COIL20_run_22/COIL20-0.02630422581787073-4299.0.tree,NEW
6,4,3,30,43,27,COIL20_new/COIL20_run_22/COIL20-0.02726946167747224-200.0.tree,NEW
4,0,1,23,28,22,COIL20_new/COIL20_run_22/COIL20-0.031808780926298574-74.0.tree,NEW
0,0,0,4,4,4,COIL20_new/COIL20_run_22/COIL20-0.14635451598479787-8.0.tree,NEW
8,2,4,29,43,26,COIL20_new/COIL20_run_22/COIL20-0.026656583016618662-217.0.tree,NEW
0,0,0,8,8,8,COIL20_new/COIL20_run_22/COIL20-0.101341346691259-16.0.tree,NEW
1,0,0,15,16,15,COIL20_new/COIL20_run_22/COIL20-0.05851138078470797-32.0.tree,NEW
6,0,1,24,31,22,COIL20_new/COIL20_run_22/COIL20-0.030207751136447414-90.0.tree,NEW
3,0,1,22,26,21,COIL20_new/COIL20_run_22/COIL20-0.036023374040539125-60.0.tree,NEW
0,0,0,2,2,2,COIL20_new/COIL20_run_22/COIL20-0.18340687644384807-4.0.tree,NEW
7,2,6,31,46,26,COIL20_new/COIL20_run_22/COIL20-0.02637095722482996-451.0.tree,NEW
1,0,0,14,15,14,COIL20_new/COIL20_run_22/COIL20-0.058598360999329024-30.0.tree,NEW
4,0,1,22,27,21,COIL20_new/COIL20_run_22/COIL20-0.03375695143080737-62.0.tree,NEW
8,2,9,34,53,28,COIL20_new/COIL20_run_22/COIL20-0.02594275141590341-70280.0.tree,NEW
6,0,2,25,33,23,COIL20_new/COIL20_run_22/COIL20-0.030107380393472716-103.0.tree,NEW
2,0,0,8,10,8,COIL20_new/COIL20_run_22/COIL20-0.09044647514717963-20.0.tree,NEW
7,5,7,35,54,28,COIL20_new/COIL20_run_22/COIL20-0.026326756837319776-607.0.tree,NEW
7,2,6,31,46,29,COIL20_new/COIL20_run_22/COIL20-0.026487932222966803-416.0.tree,NEW
5,0,1,23,29,21,COIL20_new/COIL20_run_22/COIL20-0.03119749748490863-76.0.tree,NEW
2,1,0,21,24,20,COIL20_new/COIL20_run_22/COIL20-0.03843986371935354-48.0.tree,NEW
3,1,0,21,25,21,COIL20_new/COIL20_run_22/COIL20-0.03779300804828972-56.0.tree,NEW
2,0,0,7,9,7,COIL20_new/COIL20_run_22/COIL20-0.09770616756092115-18.0.tree,NEW
6,2,3,28,39,25,COIL20_new/COIL20_run_22/COIL20-0.027876460149787397-190.0.tree,NEW
0,0,0,5,5,5,COIL20_new/COIL20_run_22/COIL20-0.12395109080408379-10.0.tree,NEW
6,2,2,27,37,25,COIL20_new/COIL20_run_22/COIL20-0.028266462199119602-153.0.tree,NEW
6,2,4,29,41,27,COIL20_new/COIL20_run_22/COIL20-0.02690713726805183-203.0.tree,NEW
6,3,3,29,41,25,COIL20_new/COIL20_run_22/COIL20-0.02732408338922354-193.0.tree,NEW
0,1,0,13,14,11,COIL20_new/COIL20_run_22/COIL20-0.07367108903420594-26.0.tree,NEW
6,1,1,25,33,23,COIL20_new/COIL20_run_22/COIL20-0.0294211798569185-138.0.tree,NEW
0,1,0,12,13,10,COIL20_new/COIL20_run_22/COIL20-0.07864638059840517-24.0.tree,NEW
1,1,0,16,18,15,COIL20_new/COIL20_run_22/COIL20-0.058041559542439836-34.0.tree,NEW
3,0,0,21,24,20,COIL20_new/COIL20_run_22/COIL20-0.03690912838139898-58.0.tree,NEW
6,1,2,26,35,24,COIL20_new/COIL20_run_22/COIL20-0.02938629461956943-151.0.tree,NEW
7,2,7,32,48,26,COIL20_new/COIL20_run_22/COIL20-0.026239625251508636-4304.0.tree,NEW
3,1,4,26,34,25,COIL20_new/COIL20_run_23/COIL20-0.02731728332960759-69.0.tree,NEW
6,2,5,28,41,27,COIL20_new/COIL20_run_23/COIL20-0.025969159866606917-89.0.tree,NEW
3,0,3,24,30,23,COIL20_new/COIL20_run_23/COIL20-0.030213398446232886-64.0.tree,NEW
0,0,1,8,9,8,COIL20_new/COIL20_run_23/COIL20-0.10130162921976271-16.0.tree,NEW
2,0,3,23,28,23,COIL20_new/COIL20_run_23/COIL20-0.03413747531485223-50.0.tree,NEW
7,2,9,32,50,29,COIL20_new/COIL20_run_23/COIL20-0.025514405879722646-8386.0.tree,NEW
0,0,2,10,12,10,COIL20_new/COIL20_run_23/COIL20-0.09096514270810097-20.0.tree,NEW
4,2,4,27,37,25,COIL20_new/COIL20_run_23/COIL20-0.027054246776958002-76.0.tree,NEW
3,2,4,27,36,25,COIL20_new/COIL20_run_23/COIL20-0.027248129983604985-72.0.tree,NEW
0,0,2,11,13,11,COIL20_new/COIL20_run_23/COIL20-0.07953676922646985-22.0.tree,NEW
6,2,6,29,43,27,COIL20_new/COIL20_run_23/COIL20-0.02560313268499853-339.0.tree,NEW
7,2,7,30,46,28,COIL20_new/COIL20_run_23/COIL20-0.025573731742305705-414.0.tree,NEW
0,0,2,15,17,15,COIL20_new/COIL20_run_23/COIL20-0.06401123174230627-30.0.tree,NEW
0,0,1,6,7,6,COIL20_new/COIL20_run_23/COIL20-0.14567617510619257-12.0.tree,NEW
1,1,0,6,8,6,COIL20_new/COIL20_run_23/COIL20-0.1259604152693941-14.0.tree,NEW
6,2,5,28,41,26,COIL20_new/COIL20_run_23/COIL20-0.025723088531186766-109.0.tree,NEW
6,3,9,33,51,28,COIL20_new/COIL20_run_23/COIL20-0.0255073612974146-32962.0.tree,NEW
5,2,5,28,40,27,COIL20_new/COIL20_run_23/COIL20-0.025796573422013802-105.0.tree,NEW
2,0,3,22,27,22,COIL20_new/COIL20_run_23/COIL20-0.03831338726805328-48.0.tree,NEW
5,2,4,27,38,25,COIL20_new/COIL20_run_23/COIL20-0.026828435893135882-78.0.tree,NEW
6,2,4,27,39,25,COIL20_new/COIL20_run_23/COIL20-0.0266752366048148-82.0.tree,NEW
4,0,3,24,31,23,COIL20_new/COIL20_run_23/COIL20-0.02973221272076959-66.0.tree,NEW
0,0,1,4,5,4,COIL20_new/COIL20_run_23/COIL20-0.1764158329607271-8.0.tree,NEW
1,0,3,24,28,23,COIL20_new/COIL20_run_23/COIL20-0.03367742333631446-60.0.tree,NEW
1,0,3,20,24,20,COIL20_new/COIL20_run_23/COIL20-0.040014659717564405-42.0.tree,NEW
0,0,0,2,2,2,COIL20_new/COIL20_run_23/COIL20-0.2092874958081825-4.0.tree,NEW
4,0,4,25,33,24,COIL20_new/COIL20_run_23/COIL20-0.028988630859229425-68.0.tree,NEW
7,2,5,28,42,25,COIL20_new/COIL20_run_23/COIL20-0.025698671193829625-133.0.tree,NEW
0,0,1,5,6,5,COIL20_new/COIL20_run_23/COIL20-0.153233207113048-10.0.tree,NEW
6,3,5,29,43,27,COIL20_new/COIL20_run_23/COIL20-0.0256968430956106-136.0.tree,NEW
7,2,8,31,48,28,COIL20_new/COIL20_run_23/COIL20-0.02555533432073881-636.0.tree,NEW
1,0,0,2,3,2,COIL20_new/COIL20_run_23/COIL20-0.20071276035844687-6.0.tree,NEW
7,2,5,28,42,26,COIL20_new/COIL20_run_23/COIL20-0.02567849224979496-157.0.tree,NEW
0,0,0,1,1,1,COIL20_new/COIL20_run_23/COIL20-0.28143654752589625-2.0.tree,NEW
0,0,2,12,14,12,COIL20_new/COIL20_run_23/COIL20-0.07368274461584384-24.0.tree,NEW
0,0,2,13,15,13,COIL20_new/COIL20_run_23/COIL20-0.0687629014829726-26.0.tree,NEW
0,1,0,20,21,20,COIL20_new/COIL20_run_24/COIL20-0.05165327613831211-40.0.tree,NEW
7,1,4,27,39,22,COIL20_new/COIL20_run_24/COIL20-0.027170686153961066-229.0.tree,NEW
8,2,5,29,44,26,COIL20_new/COIL20_run_24/COIL20-0.026736926186750665-244.0.tree,NEW
0,1,0,18,19,18,COIL20_new/COIL20_run_24/COIL20-0.05846529407928991-36.0.tree,NEW
10,2,8,32,52,28,COIL20_new/COIL20_run_24/COIL20-0.025872654910947146-1540.0.tree,NEW
10,3,10,35,58,27,COIL20_new/COIL20_run_24/COIL20-0.025737864688128054-132064.0.tree,NEW
1,1,0,12,14,12,COIL20_new/COIL20_run_24/COIL20-0.06339362564274476-26.0.tree,NEW
10,2,5,29,46,25,COIL20_new/COIL20_run_24/COIL20-0.026155649172814932-444.0.tree,NEW
5,1,1,24,31,21,COIL20_new/COIL20_run_24/COIL20-0.032462168846411676-78.0.tree,NEW
10,2,8,32,52,28,COIL20_new/COIL20_run_24/COIL20-0.02589820171026158-1484.0.tree,NEW
10,2,9,33,54,28,COIL20_new/COIL20_run_24/COIL20-0.02582373872866789-2084.0.tree,NEW
9,2,10,34,55,28,COIL20_new/COIL20_run_24/COIL20-0.025823610645353046-2668.0.tree,NEW
1,1,0,21,23,20,COIL20_new/COIL20_run_24/COIL20-0.04147227112676044-44.0.tree,NEW
0,1,0,11,12,11,COIL20_new/COIL20_run_24/COIL20-0.08032965152023225-22.0.tree,NEW
9,2,5,29,45,27,COIL20_new/COIL20_run_24/COIL20-0.02634327958491678-436.0.tree,NEW
1,1,0,15,17,15,COIL20_new/COIL20_run_24/COIL20-0.0597563855354355-32.0.tree,NEW
1,1,0,13,15,13,COIL20_new/COIL20_run_24/COIL20-0.06282230419554358-28.0.tree,NEW
0,0,0,6,6,6,COIL20_new/COIL20_run_24/COIL20-0.1400159638385871-12.0.tree,NEW
10,2,9,33,54,30,COIL20_new/COIL20_run_24/COIL20-0.02583921352187124-2056.0.tree,NEW
6,1,1,24,32,21,COIL20_new/COIL20_run_24/COIL20-0.032395763469707684-82.0.tree,NEW
1,1,0,20,22,20,COIL20_new/COIL20_run_24/COIL20-0.04787151147626528-42.0.tree,NEW
10,2,11,35,58,29,COIL20_new/COIL20_run_24/COIL20-0.02578958705939327-4054.25.tree,NEW
5,1,1,24,31,21,COIL20_new/COIL20_run_24/COIL20-0.02743875288769676-87.0.tree,NEW
0,0,0,2,2,2,COIL20_new/COIL20_run_24/COIL20-1.3232883411580572-4.0.tree,NEW
11,2,10,34,57,28,COIL20_new/COIL20_run_24/COIL20-0.025839923802072062-1756.0.tree,NEW
9,2,7,31,49,27,COIL20_new/COIL20_run_24/COIL20-0.02603180425143442-944.0.tree,NEW
0,0,0,4,4,4,COIL20_new/COIL20_run_24/COIL20-0.17070991923764828-8.0.tree,NEW
1,1,0,11,13,11,COIL20_new/COIL20_run_24/COIL20-0.06877078442879525-24.0.tree,NEW
10,2,6,30,48,27,COIL20_new/COIL20_run_24/COIL20-0.02614689293166328-532.0.tree,NEW
0,0,0,3,3,3,COIL20_new/COIL20_run_24/COIL20-0.20789839732841509-6.0.tree,NEW
0,1,0,10,11,10,COIL20_new/COIL20_run_24/COIL20-0.09157338708174967-20.0.tree,NEW
1,1,0,14,16,14,COIL20_new/COIL20_run_24/COIL20-0.06050885172143994-30.0.tree,NEW
0,1,0,19,20,19,COIL20_new/COIL20_run_24/COIL20-0.05576135051046999-38.0.tree,NEW
0,1,0,9,10,9,COIL20_new/COIL20_run_24/COIL20-0.09662885880095395-18.0.tree,NEW
4,1,1,24,30,21,COIL20_new/COIL20_run_24/COIL20-0.03420895744839436-76.0.tree,NEW
0,1,0,7,8,7,COIL20_new/COIL20_run_30/COIL20-0.1129058960242938-14.0.tree,NEW
9,7,7,38,61,32,COIL20_new/COIL20_run_30/COIL20-0.02659589481332414-491.0.tree,NEW
1,1,0,12,14,12,COIL20_new/COIL20_run_30/COIL20-0.06750394729488007-26.0.tree,NEW
13,5,8,37,63,31,COIL20_new/COIL20_run_30/COIL20-0.026543054624040163-520.0.tree,NEW
7,3,3,28,41,25,COIL20_new/COIL20_run_30/COIL20-0.02847887091064949-151.0.tree,NEW
8,3,6,31,48,30,COIL20_new/COIL20_run_30/COIL20-0.027921755067442267-160.0.tree,NEW
0,1,0,8,9,8,COIL20_new/COIL20_run_30/COIL20-0.11105602364185058-16.0.tree,NEW
14,7,10,43,74,34,COIL20_new/COIL20_run_30/COIL20-0.02617919321484463-20300.0.tree,NEW
1,0,2,20,23,19,COIL20_new/COIL20_run_30/COIL20-0.050577318075116784-52.0.tree,NEW
0,0,0,1,1,1,COIL20_new/COIL20_run_30/COIL20-0.251461302537447-2.0.tree,NEW
4,0,2,23,29,22,COIL20_new/COIL20_run_30/COIL20-0.034149305555556064-64.0.tree,NEW
5,0,2,23,30,22,COIL20_new/COIL20_run_30/COIL20-0.03309792784484622-66.0.tree,NEW
0,0,0,2,2,2,COIL20_new/COIL20_run_30/COIL20-0.19246127226320903-4.0.tree,NEW
8,6,9,39,62,33,COIL20_new/COIL20_run_30/COIL20-0.02646426009762326-539.0.tree,NEW
1,1,2,22,26,21,COIL20_new/COIL20_run_30/COIL20-0.046215731891348366-56.0.tree,NEW
0,1,0,11,12,11,COIL20_new/COIL20_run_30/COIL20-0.07939721663313193-22.0.tree,NEW
2,0,2,23,27,22,COIL20_new/COIL20_run_30/COIL20-0.0357264186973697-60.0.tree,NEW
0,1,0,9,10,9,COIL20_new/COIL20_run_30/COIL20-0.10456505235114366-18.0.tree,NEW
14,7,10,43,74,36,COIL20_new/COIL20_run_30/COIL20-0.02622834227587728-20290.0.tree,NEW
0,1,0,10,11,10,COIL20_new/COIL20_run_30/COIL20-0.08362403588195866-20.0.tree,NEW
7,1,3,26,37,26,COIL20_new/COIL20_run_30/COIL20-0.028481944910203172-135.0.tree,NEW
0,0,1,6,7,6,COIL20_new/COIL20_run_30/COIL20-0.13935990945674104-12.0.tree,NEW
5,4,2,27,38,23,COIL20_new/COIL20_run_30/COIL20-0.031792199959012946-128.0.tree,NEW
11,8,8,40,67,34,COIL20_new/COIL20_run_30/COIL20-0.026376674398241984-2196.0.tree,NEW
1,0,0,4,5,4,COIL20_new/COIL20_run_30/COIL20-0.1395650174193308-10.0.tree,NEW
1,1,2,21,25,19,COIL20_new/COIL20_run_30/COIL20-0.05055141031373461-54.0.tree,NEW
1,1,1,16,19,16,COIL20_new/COIL20_run_30/COIL20-0.05796675888665348-34.0.tree,NEW
6,3,2,26,37,23,COIL20_new/COIL20_run_30/COIL20-0.03181763031895052-108.0.tree,NEW
9,3,5,32,49,29,COIL20_new/COIL20_run_30/COIL20-0.027099134156792826-185.0.tree,NEW
10,5,6,35,56,31,COIL20_new/COIL20_run_30/COIL20-0.026998414095686152-258.0.tree,NEW
2,1,1,18,22,17,COIL20_new/COIL20_run_30/COIL20-0.05774659531261639-50.0.tree,NEW
7,0,3,25,35,23,COIL20_new/COIL20_run_30/COIL20-0.030378835513078684-130.0.tree,NEW
1,1,0,11,13,11,COIL20_new/COIL20_run_30/COIL20-0.07761166536254571-24.0.tree,NEW
1,0,2,23,26,22,COIL20_new/COIL20_run_30/COIL20-0.03942797991653668-58.0.tree,NEW
0,0,0,3,3,3,COIL20_new/COIL20_run_30/COIL20-0.18840482711081308-6.0.tree,NEW
9,4,5,33,51,29,COIL20_new/COIL20_run_30/COIL20-0.027014692320591227-235.0.tree,NEW
14,7,10,42,73,32,COIL20_new/COIL20_run_30/COIL20-0.026372505868545226-6304.0.tree,NEW
6,0,2,23,31,22,COIL20_new/COIL20_run_30/COIL20-0.03182930918846377-68.0.tree,NEW
10,8,7,40,65,32,COIL20_new/COIL20_run_30/COIL20-0.02639883281168548-1949.0.tree,NEW
1,0,0,3,4,3,COIL20_new/COIL20_run_30/COIL20-0.16014348824428026-8.0.tree,NEW
10,6,6,36,58,31,COIL20_new/COIL20_run_30/COIL20-0.02661096206870872-277.0.tree,NEW
277,87,103,620,1087,446,COIL20_old/20/COIL20-0.013526809002160356-67.0.tree,OLD
137,49,61,341,588,256,COIL20_old/20/COIL20-0.015096248789030542-59.0.tree,OLD
126,38,37,264,465,187,COIL20_old/20/COIL20-0.020429265407258146-44.0.tree,OLD
133,41,46,289,509,225,COIL20_old/20/COIL20-0.020755307306803028-43.0.tree,OLD
297,119,147,702,1265,438,COIL20_old/20/COIL20-0.03540293846411846-5.0.tree,OLD
174,60,63,391,688,286,COIL20_old/20/COIL20-0.016116106360384075-55.0.tree,OLD
396,144,153,901,1594,587,COIL20_old/20/COIL20-0.012455578377673249-72.0.tree,OLD
159,55,62,376,652,272,COIL20_old/20/COIL20-0.016024398707057463-57.0.tree,OLD
744,290,293,1632,2959,763,COIL20_old/20/COIL20-0.022976947332142006-26.0.tree,OLD
464,163,170,1029,1826,620,COIL20_old/20/COIL20-0.010915865563753069-85.0.tree,OLD
152,50,54,342,598,260,COIL20_old/20/COIL20-0.0176619788173491-51.0.tree,OLD
260,80,101,590,1031,430,COIL20_old/20/COIL20-0.013747612992770941-65.0.tree,OLD
157,51,53,346,607,257,COIL20_old/20/COIL20-0.019243656382741003-47.0.tree,OLD
388,141,154,894,1577,584,COIL20_old/20/COIL20-0.01315732357105498-70.0.tree,OLD
746,296,306,1675,3023,776,COIL20_old/20/COIL20-0.023154354366941243-19.0.tree,OLD
466,165,172,1030,1833,621,COIL20_old/20/COIL20-0.01118964947089951-82.0.tree,OLD
138,49,62,347,596,261,COIL20_old/20/COIL20-0.014247009836798274-61.0.tree,OLD
396,144,153,903,1596,587,COIL20_old/20/COIL20-0.012332560175869645-74.0.tree,OLD
154,51,56,353,614,260,COIL20_old/20/COIL20-0.017331174547283112-53.0.tree,OLD
392,142,153,904,1591,587,COIL20_old/20/COIL20-0.013489420318204937-69.0.tree,OLD
133,41,46,288,508,225,COIL20_old/20/COIL20-0.020890528355318017-42.0.tree,OLD
126,38,37,261,462,188,COIL20_old/20/COIL20-0.019905882051569068-45.0.tree,OLD
746,296,306,1673,3021,775,COIL20_old/20/COIL20-0.02350826020940394-17.0.tree,OLD
152,50,54,343,599,261,COIL20_old/20/COIL20-0.017638772449511453-52.0.tree,OLD
224,80,102,494,900,337,COIL20_old/20/COIL20-0.03226609657947532-6.0.tree,OLD
139,46,56,325,566,251,COIL20_old/20/COIL20-0.01567966828750378-58.0.tree,OLD
746,296,306,1674,3022,776,COIL20_old/20/COIL20-0.02334758551307875-18.0.tree,OLD
1001,418,396,2200,4015,866,COIL20_old/20/COIL20-0.021803506222520586-35.0.tree,OLD
1006,388,404,2206,4004,860,COIL20_old/20/COIL20-0.0804871939973168-2.0.tree,OLD
414,147,157,931,1649,589,COIL20_old/20/COIL20-0.011618134734331986-80.0.tree,OLD
259,80,101,589,1029,429,COIL20_old/20/COIL20-0.013752899340487235-64.0.tree,OLD
773,318,313,1721,3125,797,COIL20_old/20/COIL20-0.024597771816081304-14.0.tree,OLD
432,176,187,1002,1797,549,COIL20_old/20/COIL20-0.05046502393993574-3.0.tree,OLD
803,322,322,1771,3218,811,COIL20_old/20/COIL20-0.02566370444891547-11.0.tree,OLD
255,80,101,586,1022,427,COIL20_old/20/COIL20-0.013936780404650684-63.0.tree,OLD
242,88,108,543,981,330,COIL20_old/20/COIL20-0.03007027116402039-7.0.tree,OLD
820,335,336,1831,3322,811,COIL20_old/20/COIL20-0.022134671454653976-30.0.tree,OLD
414,147,157,932,1650,590,COIL20_old/20/COIL20-0.011478186247112554-81.0.tree,OLD
795,320,323,1783,3221,817,COIL20_old/20/COIL20-0.024621082979357722-13.0.tree,OLD
414,147,157,930,1648,590,COIL20_old/20/COIL20-0.011765628493181468-79.0.tree,OLD
466,165,172,1032,1835,620,COIL20_old/20/COIL20-0.01100045877114536-84.0.tree,OLD
732,288,294,1620,2934,764,COIL20_old/20/COIL20-0.022430194593486885-28.0.tree,OLD
793,319,321,1769,3202,813,COIL20_old/20/COIL20-0.026148115545123363-10.0.tree,OLD
138,49,61,342,590,256,COIL20_old/20/COIL20-0.01447100426633996-60.0.tree,OLD
255,80,101,585,1021,427,COIL20_old/20/COIL20-0.013966530665474541-62.0.tree,OLD
806,326,331,1797,3260,805,COIL20_old/20/COIL20-0.023779459162380945-16.0.tree,OLD
396,144,153,900,1593,587,COIL20_old/20/COIL20-0.012952588214471927-71.0.tree,OLD
424,152,193,936,1705,549,COIL20_old/20/COIL20-0.028066302910052576-9.0.tree,OLD
154,51,56,354,615,261,COIL20_old/20/COIL20-0.016692842238617167-54.0.tree,OLD
998,416,393,2181,3988,865,COIL20_old/20/COIL20-0.021974089909830408-33.0.tree,OLD
127,37,42,272,478,210,COIL20_old/20/COIL20-0.021392230699008585-41.0.tree,OLD
823,336,336,1834,3329,811,COIL20_old/20/COIL20-0.022129385106938015-31.0.tree,OLD
424,152,193,935,1704,549,COIL20_old/20/COIL20-0.02837369122140293-8.0.tree,OLD
396,144,153,902,1595,587,COIL20_old/20/COIL20-0.01233949996273831-73.0.tree,OLD
392,142,153,903,1590,586,COIL20_old/20/COIL20-0.013504394422088228-68.0.tree,OLD
414,149,157,930,1650,600,COIL20_old/20/COIL20-0.012081214136672014-76.0.tree,OLD
820,335,336,1830,3321,811,COIL20_old/20/COIL20-0.022297383840076568-29.0.tree,OLD
66,33,33,179,311,130,COIL20_old/20/COIL20-0.13963250568224173-1.0.tree,OLD
161,55,55,353,624,254,COIL20_old/20/COIL20-0.019804998975333554-46.0.tree,OLD
823,336,336,1835,3330,812,COIL20_old/20/COIL20-0.022096607422312176-32.0.tree,OLD
157,51,53,347,608,258,COIL20_old/20/COIL20-0.01902497158879235-48.0.tree,OLD
413,148,157,926,1644,593,COIL20_old/20/COIL20-0.012004107981220369-77.0.tree,OLD
152,52,54,343,601,258,COIL20_old/20/COIL20-0.018565944276771273-49.0.tree,OLD
153,52,54,344,603,259,COIL20_old/20/COIL20-0.0185539626648773-50.0.tree,OLD
288,114,144,707,1253,410,COIL20_old/20/COIL20-0.04100095946046611-4.0.tree,OLD
414,147,157,929,1647,590,COIL20_old/20/COIL20-0.011967709031970308-78.0.tree,OLD
1002,419,397,2201,4019,865,COIL20_old/20/COIL20-0.021952082867576217-34.0.tree,OLD
793,320,322,1777,3212,814,COIL20_old/20/COIL20-0.024875118768164506-12.0.tree,OLD
409,147,156,919,1631,594,COIL20_old/20/COIL20-0.012280523418287614-75.0.tree,OLD
466,165,172,1031,1834,621,COIL20_old/20/COIL20-0.011183245305164291-83.0.tree,OLD
260,80,101,591,1032,431,COIL20_old/20/COIL20-0.013740091009016242-66.0.tree,OLD
571,190,201,1184,2146,658,COIL20_old/18/COIL20-0.015137666275430839-65.0.tree,OLD
546,180,202,1180,2108,673,COIL20_old/18/COIL20-0.013155821503092024-71.0.tree,OLD
417,117,176,846,1556,498,COIL20_old/18/COIL20-0.03539426373053178-5.0.tree,OLD
564,189,209,1208,2170,680,COIL20_old/18/COIL20-0.013761643937700963-68.0.tree,OLD
553,184,203,1205,2145,677,COIL20_old/18/COIL20-0.011965124077799927-76.0.tree,OLD
549,180,201,1183,2113,675,COIL20_old/18/COIL20-0.012600498826290718-74.0.tree,OLD
560,194,200,1170,2124,658,COIL20_old/18/COIL20-0.020916063510694194-45.0.tree,OLD
603,201,254,1327,2385,686,COIL20_old/18/COIL20-0.024642612620165316-16.0.tree,OLD
627,214,257,1369,2467,693,COIL20_old/18/COIL20-0.024567381138682842-17.0.tree,OLD
566,208,256,1335,2365,706,COIL20_old/18/COIL20-0.0281456679894177-10.0.tree,OLD
621,213,257,1361,2452,689,COIL20_old/18/COIL20-0.02488815997838878-15.0.tree,OLD
632,215,258,1378,2483,695,COIL20_old/18/COIL20-0.024154626835085513-20.0.tree,OLD
632,215,258,1377,2482,695,COIL20_old/18/COIL20-0.024217748621358393-19.0.tree,OLD
627,214,257,1370,2468,693,COIL20_old/18/COIL20-0.02443562998360521-18.0.tree,OLD
564,190,209,1210,2173,682,COIL20_old/18/COIL20-0.013581570441166368-69.0.tree,OLD
579,198,208,1203,2188,667,COIL20_old/18/COIL20-0.017485014252179076-52.0.tree,OLD
554,184,206,1212,2156,677,COIL20_old/18/COIL20-0.012014738896341026-75.0.tree,OLD
322,91,141,670,1224,413,COIL20_old/18/COIL20-0.03848051270586472-4.0.tree,OLD
585,200,214,1219,2218,673,COIL20_old/18/COIL20-0.019793122158878573-47.0.tree,OLD
661,263,296,1526,2746,739,COIL20_old/18/COIL20-0.03315316668529661-6.0.tree,OLD
632,218,260,1378,2488,692,COIL20_old/18/COIL20-0.025173168641477894-14.0.tree,OLD
540,196,249,1264,2249,659,COIL20_old/18/COIL20-0.02631981705045161-13.0.tree,OLD
545,197,247,1283,2272,671,COIL20_old/18/COIL20-0.023981702716297015-24.0.tree,OLD
571,190,201,1182,2144,656,COIL20_old/18/COIL20-0.015406780963558964-63.0.tree,OLD
571,190,201,1183,2145,657,COIL20_old/18/COIL20-0.015305292402563786-64.0.tree,OLD
585,198,210,1212,2205,667,COIL20_old/18/COIL20-0.01687097119755593-56.0.tree,OLD
949,364,394,2168,3875,867,COIL20_old/18/COIL20-0.02274526790371806-34.0.tree,OLD
603,221,274,1418,2516,727,COIL20_old/18/COIL20-0.028867708566212014-9.0.tree,OLD
930,362,386,2128,3806,862,COIL20_old/18/COIL20-0.022822420634920515-33.0.tree,OLD
580,208,261,1356,2405,672,COIL20_old/18/COIL20-0.023389736567553443-26.0.tree,OLD
554,184,203,1207,2148,678,COIL20_old/18/COIL20-0.011934500521648461-78.0.tree,OLD
554,184,203,1206,2147,678,COIL20_old/18/COIL20-0.011940124543558195-77.0.tree,OLD
585,200,214,1218,2217,672,COIL20_old/18/COIL20-0.020028853677620195-46.0.tree,OLD
560,194,200,1169,2123,658,COIL20_old/18/COIL20-0.021099292514345613-44.0.tree,OLD
585,200,212,1218,2215,673,COIL20_old/18/COIL20-0.01945380617035619-48.0.tree,OLD
570,190,201,1178,2139,658,COIL20_old/18/COIL20-0.015609688221924045-60.0.tree,OLD
544,182,198,1149,2073,657,COIL20_old/18/COIL20-0.01382071363365428-67.0.tree,OLD
579,198,208,1204,2189,667,COIL20_old/18/COIL20-0.01693625875624083-53.0.tree,OLD
953,365,393,2173,3884,870,COIL20_old/18/COIL20-0.021180625419180865-36.0.tree,OLD
588,202,211,1222,2223,676,COIL20_old/18/COIL20-0.018069132386914377-51.0.tree,OLD
570,190,201,1179,2140,658,COIL20_old/18/COIL20-0.015598032640285864-61.0.tree,OLD
325,84,149,652,1210,329,COIL20_old/18/COIL20-0.075109779044638-2.0.tree,OLD
585,200,212,1220,2217,674,COIL20_old/18/COIL20-0.01809062709590853-50.0.tree,OLD
576,197,205,1201,2179,663,COIL20_old/18/COIL20-0.015774857478202287-59.0.tree,OLD
570,190,201,1186,2147,660,COIL20_old/18/COIL20-0.015043874357254572-66.0.tree,OLD
609,239,308,1481,2637,764,COIL20_old/18/COIL20-0.03001666247484841-8.0.tree,OLD
585,200,212,1219,2216,674,COIL20_old/18/COIL20-0.01878472222222266-49.0.tree,OLD
545,197,247,1284,2273,672,COIL20_old/18/COIL20-0.023955282621654583-25.0.tree,OLD
546,180,202,1182,2110,674,COIL20_old/18/COIL20-0.012675066603323293-73.0.tree,OLD
196,69,101,436,802,192,COIL20_old/18/COIL20-0.12777457569491002-1.0.tree,OLD
570,190,201,1180,2141,658,COIL20_old/18/COIL20-0.015502948245025239-62.0.tree,OLD
527,155,214,1062,1958,549,COIL20_old/18/COIL20-0.05294393676876036-3.0.tree,OLD
949,363,393,2162,3867,865,COIL20_old/18/COIL20-0.022357012445039237-35.0.tree,OLD
447,178,222,1117,1964,641,COIL20_old/18/COIL20-0.03145415315969918-7.0.tree,OLD
546,180,202,1181,2109,673,COIL20_old/18/COIL20-0.012939220973991916-72.0.tree,OLD
585,198,209,1211,2203,666,COIL20_old/18/COIL20-0.016920760675162072-54.0.tree,OLD
556,185,203,1211,2155,679,COIL20_old/18/COIL20-0.011922681924882383-79.0.tree,OLD
605,202,266,1364,2437,712,COIL20_old/18/COIL20-0.027677779640807698-11.0.tree,OLD
928,360,385,2123,3796,861,COIL20_old/18/COIL20-0.023302884436246507-32.0.tree,OLD
547,181,202,1180,2110,671,COIL20_old/18/COIL20-0.013197658171250404-70.0.tree,OLD
576,197,205,1199,2177,663,COIL20_old/18/COIL20-0.01680387882852641-57.0.tree,OLD
585,198,209,1212,2204,666,COIL20_old/18/COIL20-0.016902118730904192-55.0.tree,OLD
576,197,205,1200,2178,663,COIL20_old/18/COIL20-0.015967389988077174-58.0.tree,OLD
219,87,83,537,926,363,COIL20_old/27/COIL20-0.010693198543109517-78.0.tree,OLD
175,76,64,427,742,278,COIL20_old/27/COIL20-0.01308659829346448-62.0.tree,OLD
80,46,24,212,362,137,COIL20_old/27/COIL20-0.018860489324837082-41.0.tree,OLD
155,72,63,390,680,271,COIL20_old/27/COIL20-0.01514046082047904-53.0.tree,OLD
80,46,24,211,361,136,COIL20_old/27/COIL20-0.019386073384753733-40.0.tree,OLD
587,268,263,1403,2521,689,COIL20_old/27/COIL20-0.03206504070720584-8.0.tree,OLD
175,76,64,430,745,278,COIL20_old/27/COIL20-0.012918424901260384-65.0.tree,OLD
784,307,333,1838,3262,789,COIL20_old/27/COIL20-0.02764138069155614-18.0.tree,OLD
208,82,86,516,892,331,COIL20_old/27/COIL20-0.011091630803338304-75.0.tree,OLD
497,220,215,1154,2086,610,COIL20_old/27/COIL20-0.03354178310604328-7.0.tree,OLD
80,40,27,202,349,139,COIL20_old/27/COIL20-0.02360623230121467-34.0.tree,OLD
294,129,139,694,1256,442,COIL20_old/27/COIL20-0.037766867408152716-6.0.tree,OLD
577,193,248,1359,2377,588,COIL20_old/27/COIL20-0.06105180853640357-3.0.tree,OLD
60,37,21,172,290,112,COIL20_old/27/COIL20-0.022717497112303753-36.0.tree,OLD
1067,408,431,2398,4304,891,COIL20_old/27/COIL20-0.02697166797078787-22.0.tree,OLD
88,44,26,214,372,133,COIL20_old/27/COIL20-0.01963627831805642-39.0.tree,OLD
89,46,35,243,413,162,COIL20_old/27/COIL20-0.01709819099783927-47.0.tree,OLD
198,80,75,486,839,316,COIL20_old/27/COIL20-0.012124902190922326-70.0.tree,OLD
92,46,32,242,412,170,COIL20_old/27/COIL20-0.017476502533721072-45.0.tree,OLD
175,76,64,429,744,278,COIL20_old/27/COIL20-0.012937159997018388-64.0.tree,OLD
155,72,63,391,681,272,COIL20_old/27/COIL20-0.014361364948952848-54.0.tree,OLD
41,26,16,129,212,75,COIL20_old/27/COIL20-0.024222033590431458-31.0.tree,OLD
92,46,32,241,411,169,COIL20_old/27/COIL20-0.018165637342573537-44.0.tree,OLD
41,26,16,130,213,76,COIL20_old/27/COIL20-0.024091574912437075-32.0.tree,OLD
118,61,41,295,515,203,COIL20_old/27/COIL20-0.015223458808406254-52.0.tree,OLD
579,217,245,1286,2327,682,COIL20_old/27/COIL20-0.02776402628735397-15.0.tree,OLD
84,45,27,215,371,135,COIL20_old/27/COIL20-0.020603645018257843-38.0.tree,OLD
236,96,117,569,1018,286,COIL20_old/27/COIL20-0.1361326291079808-1.0.tree,OLD
210,83,75,489,857,315,COIL20_old/27/COIL20-0.012776508588568436-67.0.tree,OLD
200,82,75,495,852,323,COIL20_old/27/COIL20-0.011580594679186706-72.0.tree,OLD
172,73,61,412,718,274,COIL20_old/27/COIL20-0.013519054139651987-59.0.tree,OLD
203,83,77,507,870,326,COIL20_old/27/COIL20-0.011425916610775744-73.0.tree,OLD
500,189,213,1115,2017,623,COIL20_old/27/COIL20-0.029144170579030293-10.0.tree,OLD
37,27,16,124,204,70,COIL20_old/27/COIL20-0.025418948878456638-29.0.tree,OLD
175,76,64,428,743,278,COIL20_old/27/COIL20-0.013073126257543755-63.0.tree,OLD
142,68,58,369,637,248,COIL20_old/27/COIL20-0.014120486809746868-55.0.tree,OLD
573,216,243,1281,2313,678,COIL20_old/27/COIL20-0.0279399428981289-14.0.tree,OLD
33,22,13,107,175,65,COIL20_old/27/COIL20-0.025903569565540463-28.0.tree,OLD
92,46,32,240,410,168,COIL20_old/27/COIL20-0.01823644412772918-43.0.tree,OLD
84,45,27,214,370,135,COIL20_old/27/COIL20-0.02076031420001584-37.0.tree,OLD
217,87,84,541,929,361,COIL20_old/27/COIL20-0.010517584674714753-79.0.tree,OLD
574,218,245,1283,2320,670,COIL20_old/27/COIL20-0.028552972930172393-12.0.tree,OLD
460,208,232,1158,2058,609,COIL20_old/27/COIL20-0.04006400672553895-5.0.tree,OLD
198,80,75,485,838,315,COIL20_old/27/COIL20-0.012210869382964118-69.0.tree,OLD
89,46,35,245,415,164,COIL20_old/27/COIL20-0.01644738803189494-49.0.tree,OLD
210,89,79,520,898,341,COIL20_old/27/COIL20-0.011203796855204173-74.0.tree,OLD
372,128,178,854,1532,488,COIL20_old/27/COIL20-0.043487336053357084-4.0.tree,OLD
155,68,60,390,673,262,COIL20_old/27/COIL20-0.014027731202026605-56.0.tree,OLD
90,46,35,244,415,163,COIL20_old/27/COIL20-0.017238826477383062-46.0.tree,OLD
155,67,59,388,669,263,COIL20_old/27/COIL20-0.013723149079662267-58.0.tree,OLD
203,80,76,483,842,316,COIL20_old/27/COIL20-0.012670769990312913-68.0.tree,OLD
83,45,25,216,369,143,COIL20_old/27/COIL20-0.018604858316567163-42.0.tree,OLD
61,37,22,172,292,112,COIL20_old/27/COIL20-0.023526296668902824-35.0.tree,OLD
532,233,213,1176,2154,546,COIL20_old/27/COIL20-0.08904260051047042-2.0.tree,OLD
215,83,90,535,923,345,COIL20_old/27/COIL20-0.01094090002980841-76.0.tree,OLD
198,80,75,487,840,317,COIL20_old/27/COIL20-0.011590876276175277-71.0.tree,OLD
159,70,61,398,688,268,COIL20_old/27/COIL20-0.013939621525448531-57.0.tree,OLD
570,215,243,1275,2303,674,COIL20_old/27/COIL20-0.02808735514941596-13.0.tree,OLD
175,76,64,426,741,277,COIL20_old/27/COIL20-0.013217266562336738-61.0.tree,OLD
89,46,35,244,414,163,COIL20_old/27/COIL20-0.01674050087562312-48.0.tree,OLD
37,27,16,125,205,71,COIL20_old/27/COIL20-0.024964951747522834-30.0.tree,OLD
60,37,21,169,287,108,COIL20_old/27/COIL20-0.023687495342425036-33.0.tree,OLD
210,83,75,488,856,314,COIL20_old/27/COIL20-0.012805525281316621-66.0.tree,OLD
570,215,241,1268,2294,669,COIL20_old/27/COIL20-0.028753807567628298-11.0.tree,OLD
173,73,61,415,722,275,COIL20_old/27/COIL20-0.013489699772709696-60.0.tree,OLD
216,83,90,537,926,347,COIL20_old/27/COIL20-0.010930024591995713-77.0.tree,OLD
89,46,35,246,416,165,COIL20_old/27/COIL20-0.016080720433714335-50.0.tree,OLD
97,47,36,255,435,173,COIL20_old/27/COIL20-0.016055313361652-51.0.tree,OLD
549,206,229,1215,2199,650,COIL20_old/27/COIL20-0.031019694556226385-9.0.tree,OLD
276,105,95,628,1104,395,COIL20_old/9/COIL20-0.01408898995826846-66.0.tree,OLD
281,106,103,674,1164,453,COIL20_old/9/COIL20-0.019210797190550244-53.0.tree,OLD
283,115,109,683,1190,437,COIL20_old/9/COIL20-0.015412323477904277-61.0.tree,OLD
412,141,146,849,1548,510,COIL20_old/9/COIL20-0.029561291359267716-12.0.tree,OLD
283,110,96,639,1128,391,COIL20_old/9/COIL20-0.013400751732618399-70.0.tree,OLD
427,173,159,1011,1770,598,COIL20_old/9/COIL20-0.009992873910126987-85.0.tree,OLD
264,115,110,663,1152,436,COIL20_old/9/COIL20-0.0217142437961102-47.0.tree,OLD
259,114,107,644,1124,426,COIL20_old/9/COIL20-0.02256029230941159-43.0.tree,OLD
294,116,110,700,1220,451,COIL20_old/9/COIL20-0.01707461202399624-58.0.tree,OLD
376,142,142,795,1455,490,COIL20_old/9/COIL20-0.02549392419330926-21.0.tree,OLD
266,115,110,663,1154,437,COIL20_old/9/COIL20-0.02188825080110335-46.0.tree,OLD
261,110,89,522,982,310,COIL20_old/9/COIL20-0.16231401138311335-1.0.tree,OLD
276,105,95,629,1105,395,COIL20_old/9/COIL20-0.013637880523883816-67.0.tree,OLD
267,105,91,617,1080,383,COIL20_old/9/COIL20-0.012051999496981214-74.0.tree,OLD
399,145,149,842,1535,516,COIL20_old/9/COIL20-0.02481275383784226-28.0.tree,OLD
288,115,106,681,1190,433,COIL20_old/9/COIL20-0.014980775858857098-63.0.tree,OLD
268,105,91,618,1082,385,COIL20_old/9/COIL20-0.011633947201729222-75.0.tree,OLD
421,174,160,1004,1759,591,COIL20_old/9/COIL20-0.010651687905208651-81.0.tree,OLD
318,139,118,765,1340,472,COIL20_old/9/COIL20-0.010861220564125362-79.0.tree,OLD
418,170,158,1000,1746,599,COIL20_old/9/COIL20-0.009684589015575618-87.0.tree,OLD
262,101,92,617,1072,387,COIL20_old/9/COIL20-0.01113770586481816-76.0.tree,OLD
318,139,118,764,1339,471,COIL20_old/9/COIL20-0.01095603714881871-78.0.tree,OLD
286,111,97,646,1140,391,COIL20_old/9/COIL20-0.013432691053730461-69.0.tree,OLD
282,118,111,694,1205,441,COIL20_old/9/COIL20-0.015500002328787899-60.0.tree,OLD
412,142,148,859,1561,515,COIL20_old/9/COIL20-0.02686806021313054-17.0.tree,OLD
266,115,110,662,1153,436,COIL20_old/9/COIL20-0.022106097231537336-45.0.tree,OLD
294,109,103,678,1184,445,COIL20_old/9/COIL20-0.01823553590058946-54.0.tree,OLD
540,187,193,1104,2024,608,COIL20_old/9/COIL20-0.031932986809748265-9.0.tree,OLD
389,144,149,826,1508,506,COIL20_old/9/COIL20-0.02532393434682173-23.0.tree,OLD
235,96,89,581,1001,390,COIL20_old/9/COIL20-0.020079073980921458-52.0.tree,OLD
235,113,92,591,1031,413,COIL20_old/9/COIL20-0.023625176987853602-40.0.tree,OLD
286,115,108,684,1193,433,COIL20_old/9/COIL20-0.01511522840748214-62.0.tree,OLD
383,144,143,808,1478,497,COIL20_old/9/COIL20-0.02545024778299465-22.0.tree,OLD
432,152,156,895,1635,528,COIL20_old/9/COIL20-0.03109320273492805-10.0.tree,OLD
402,145,151,844,1542,513,COIL20_old/9/COIL20-0.025072809542440344-27.0.tree,OLD
424,173,159,1008,1764,600,COIL20_old/9/COIL20-0.010409214546538703-83.0.tree,OLD
295,108,104,683,1190,447,COIL20_old/9/COIL20-0.017703419591623026-56.0.tree,OLD
418,170,158,999,1745,599,COIL20_old/9/COIL20-0.00992926307847114-86.0.tree,OLD
254,116,107,659,1136,437,COIL20_old/9/COIL20-0.020434260656530645-50.0.tree,OLD
455,187,166,1065,1873,626,COIL20_old/9/COIL20-0.009561663965273304-88.0.tree,OLD
254,116,107,660,1137,437,COIL20_old/9/COIL20-0.020137724495118914-51.0.tree,OLD
283,110,96,640,1129,392,COIL20_old/9/COIL20-0.01313117128698199-71.0.tree,OLD
394,145,150,834,1523,509,COIL20_old/9/COIL20-0.025083126071242523-26.0.tree,OLD
426,173,159,1010,1768,598,COIL20_old/9/COIL20-0.010310369159400756-84.0.tree,OLD
395,146,144,822,1507,495,COIL20_old/9/COIL20-0.026488875381922072-20.0.tree,OLD
315,115,128,674,1232,337,COIL20_old/9/COIL20-0.07626775700499316-2.0.tree,OLD
496,205,185,1173,2059,661,COIL20_old/9/COIL20-0.00939507414859525-92.0.tree,OLD
525,212,192,1209,2138,673,COIL20_old/9/COIL20-0.009090643397421105-95.0.tree,OLD
259,114,107,645,1125,427,COIL20_old/9/COIL20-0.022428715813398836-44.0.tree,OLD
689,274,248,1486,2697,746,COIL20_old/9/COIL20-0.034676938948506375-7.0.tree,OLD
259,114,107,643,1123,425,COIL20_old/9/COIL20-0.022884890360682753-42.0.tree,OLD
285,109,100,649,1143,400,COIL20_old/9/COIL20-0.014515798494671439-64.0.tree,OLD
460,187,168,1074,1889,630,COIL20_old/9/COIL20-0.009424090841344213-89.0.tree,OLD
463,187,169,1080,1899,630,COIL20_old/9/COIL20-0.009418886001192006-90.0.tree,OLD
294,108,104,682,1188,446,COIL20_old/9/COIL20-0.017726358148893562-55.0.tree,OLD
289,111,105,682,1187,447,COIL20_old/9/COIL20-0.01745731332439121-57.0.tree,OLD
412,141,146,850,1549,510,COIL20_old/9/COIL20-0.0288064381660329-13.0.tree,OLD
500,205,186,1176,2067,662,COIL20_old/9/COIL20-0.00935776697220353-93.0.tree,OLD
254,116,107,658,1135,436,COIL20_old/9/COIL20-0.020642873444369603-49.0.tree,OLD
285,109,100,650,1144,401,COIL20_old/9/COIL20-0.014313275486250887-65.0.tree,OLD
389,144,150,829,1512,508,COIL20_old/9/COIL20-0.025141147812802522-25.0.tree,OLD
497,205,187,1173,2062,660,COIL20_old/9/COIL20-0.009127310157239998-94.0.tree,OLD
257,106,84,595,1042,379,COIL20_old/9/COIL20-0.010958598815112686-77.0.tree,OLD
322,143,125,799,1389,499,COIL20_old/9/COIL20-0.010683801885386701-80.0.tree,OLD
625,252,224,1346,2447,703,COIL20_old/9/COIL20-0.033480291471048806-8.0.tree,OLD
297,112,99,658,1166,410,COIL20_old/9/COIL20-0.013637216819434639-68.0.tree,OLD
496,205,185,1172,2058,661,COIL20_old/9/COIL20-0.00941660378940301-91.0.tree,OLD
419,157,189,898,1663,487,COIL20_old/9/COIL20-0.04788866299649763-4.0.tree,OLD
388,137,143,810,1478,496,COIL20_old/9/COIL20-0.027856013395185175-15.0.tree,OLD
259,114,107,640,1120,424,COIL20_old/9/COIL20-0.024130896490051734-39.0.tree,OLD
254,116,107,657,1134,435,COIL20_old/9/COIL20-0.020936347250167908-48.0.tree,OLD
269,103,93,617,1082,378,COIL20_old/9/COIL20-0.01217960541023938-73.0.tree,OLD
412,142,148,858,1560,514,COIL20_old/9/COIL20-0.027431836388702002-16.0.tree,OLD
291,118,108,696,1213,450,COIL20_old/9/COIL20-0.016496211062672683-59.0.tree,OLD
389,144,149,827,1509,508,COIL20_old/9/COIL20-0.025268660574558288-24.0.tree,OLD
503,167,193,1069,1932,591,COIL20_old/9/COIL20-0.03896101143900438-5.0.tree,OLD
427,176,162,1019,1784,601,COIL20_old/9/COIL20-0.010529612862359594-82.0.tree,OLD
412,142,148,860,1562,516,COIL20_old/9/COIL20-0.02656244178031203-18.0.tree,OLD
456,179,202,1037,1874,568,COIL20_old/9/COIL20-0.03622185660257854-6.0.tree,OLD
235,65,91,469,860,304,COIL20_old/9/COIL20-0.057569374580818455-3.0.tree,OLD
269,104,95,626,1094,386,COIL20_old/9/COIL20-0.012778406550414678-72.0.tree,OLD
430,149,156,898,1633,528,COIL20_old/9/COIL20-0.030222934831208692-11.0.tree,OLD
250,88,75,493,906,358,COIL20_old/11/COIL20-0.019516427267308012-45.0.tree,OLD
567,223,224,1303,2317,730,COIL20_old/11/COIL20-0.014872813268499707-61.0.tree,OLD
688,277,288,1543,2796,781,COIL20_old/11/COIL20-0.03521557586258267-7.0.tree,OLD
556,226,219,1308,2309,730,COIL20_old/11/COIL20-0.01191350650197448-77.0.tree,OLD
554,225,220,1308,2307,729,COIL20_old/11/COIL20-0.011966300115507922-75.0.tree,OLD
818,327,340,1891,3376,827,COIL20_old/11/COIL20-0.024629187159997512-22.0.tree,OLD
263,90,83,536,972,381,COIL20_old/11/COIL20-0.015191740722110603-58.0.tree,OLD
278,97,86,562,1023,384,COIL20_old/11/COIL20-0.016196973507713375-55.0.tree,OLD
567,223,224,1304,2318,730,COIL20_old/11/COIL20-0.014762882852672077-62.0.tree,OLD
572,229,227,1324,2352,732,COIL20_old/11/COIL20-0.013989236343989742-65.0.tree,OLD
612,251,272,1419,2554,733,COIL20_old/11/COIL20-0.02970181039943448-10.0.tree,OLD
567,223,224,1305,2319,730,COIL20_old/11/COIL20-0.014569302388403593-63.0.tree,OLD
483,174,169,951,1777,511,COIL20_old/11/COIL20-0.07911049631120037-2.0.tree,OLD
434,177,167,1000,1778,617,COIL20_old/11/COIL20-0.015154701356286104-59.0.tree,OLD
554,225,220,1309,2308,730,COIL20_old/11/COIL20-0.011962143229749034-76.0.tree,OLD
546,221,218,1288,2273,726,COIL20_old/11/COIL20-0.012610687271778664-71.0.tree,OLD
898,339,384,2025,3646,870,COIL20_old/11/COIL20-0.02679396983754384-14.0.tree,OLD
1120,436,477,2530,4563,930,COIL20_old/11/COIL20-0.026709446493776934-15.0.tree,OLD
559,230,219,1318,2326,730,COIL20_old/11/COIL20-0.011448319546910335-78.0.tree,OLD
818,327,339,1891,3375,822,COIL20_old/11/COIL20-0.023785024964602997-25.0.tree,OLD
547,230,219,1306,2302,724,COIL20_old/11/COIL20-0.010635630915119432-80.0.tree,OLD
282,106,133,609,1130,287,COIL20_old/11/COIL20-0.12736688650421074-1.0.tree,OLD
554,226,224,1304,2308,723,COIL20_old/11/COIL20-0.013580767009463701-68.0.tree,OLD
255,89,79,507,930,370,COIL20_old/11/COIL20-0.019202937532602826-46.0.tree,OLD
729,303,326,1707,3065,825,COIL20_old/11/COIL20-0.03925314619196679-6.0.tree,OLD
599,249,269,1410,2527,726,COIL20_old/11/COIL20-0.02744311936433419-13.0.tree,OLD
546,221,218,1289,2274,726,COIL20_old/11/COIL20-0.012421356844772524-72.0.tree,OLD
546,220,220,1291,2277,726,COIL20_old/11/COIL20-0.013381341288470905-69.0.tree,OLD
1110,433,475,2519,4537,929,COIL20_old/11/COIL20-0.026458461416648205-16.0.tree,OLD
567,223,224,1302,2316,730,COIL20_old/11/COIL20-0.014942083053878896-60.0.tree,OLD
553,224,220,1303,2300,728,COIL20_old/11/COIL20-0.012150868171994567-73.0.tree,OLD
545,226,219,1300,2290,726,COIL20_old/11/COIL20-0.010972315373724228-79.0.tree,OLD
818,327,340,1893,3378,827,COIL20_old/11/COIL20-0.023802758681720437-24.0.tree,OLD
821,325,340,1892,3378,821,COIL20_old/11/COIL20-0.023327918902303124-26.0.tree,OLD
553,226,224,1303,2306,723,COIL20_old/11/COIL20-0.013629100994857035-67.0.tree,OLD
260,87,80,522,949,363,COIL20_old/11/COIL20-0.016325848610178995-54.0.tree,OLD
408,165,165,887,1625,510,COIL20_old/11/COIL20-0.04632983083687292-4.0.tree,OLD
242,89,74,497,902,375,COIL20_old/11/COIL20-0.020271035937849846-44.0.tree,OLD
829,326,342,1901,3398,823,COIL20_old/11/COIL20-0.022592324782025386-28.0.tree,OLD
277,98,86,564,1025,384,COIL20_old/11/COIL20-0.015632545271628995-56.0.tree,OLD
842,329,347,1925,3443,828,COIL20_old/11/COIL20-0.022281024107608793-30.0.tree,OLD
264,88,83,531,966,375,COIL20_old/11/COIL20-0.019176412642521734-47.0.tree,OLD
635,247,260,1408,2550,750,COIL20_old/11/COIL20-0.03289977131306321-8.0.tree,OLD
847,329,348,1933,3457,829,COIL20_old/11/COIL20-0.021373251080557598-33.0.tree,OLD
411,165,152,864,1592,477,COIL20_old/11/COIL20-0.04194506157314237-5.0.tree,OLD
264,87,83,531,965,376,COIL20_old/11/COIL20-0.019104522971160498-48.0.tree,OLD
554,224,220,1306,2304,729,COIL20_old/11/COIL20-0.012116506911841685-74.0.tree,OLD
546,221,218,1287,2272,726,COIL20_old/11/COIL20-0.012917551605931832-70.0.tree,OLD
820,325,339,1888,3372,821,COIL20_old/11/COIL20-0.022890374655339885-27.0.tree,OLD
260,87,80,521,948,363,COIL20_old/11/COIL20-0.016532773027051362-53.0.tree,OLD
805,324,330,1854,3313,826,COIL20_old/11/COIL20-0.0246964076123406-21.0.tree,OLD
599,249,268,1404,2520,723,COIL20_old/11/COIL20-0.029228041862284948-11.0.tree,OLD
818,327,340,1892,3377,827,COIL20_old/11/COIL20-0.02414868842685791-23.0.tree,OLD
1110,433,475,2520,4538,930,COIL20_old/11/COIL20-0.026006548550562614-17.0.tree,OLD
277,93,85,556,1011,383,COIL20_old/11/COIL20-0.018231448878456513-51.0.tree,OLD
575,228,228,1325,2356,730,COIL20_old/11/COIL20-0.014015225612936388-64.0.tree,OLD
845,329,347,1929,3450,829,COIL20_old/11/COIL20-0.021709236902899276-32.0.tree,OLD
266,87,83,535,971,376,COIL20_old/11/COIL20-0.01856068121693183-50.0.tree,OLD
263,90,83,535,971,380,COIL20_old/11/COIL20-0.015347047563155691-57.0.tree,OLD
538,222,216,1289,2265,722,COIL20_old/11/COIL20-0.010629413052388292-81.0.tree,OLD
266,87,83,534,970,376,COIL20_old/11/COIL20-0.01881266767270351-49.0.tree,OLD
848,329,348,1935,3460,831,COIL20_old/11/COIL20-0.021306647756911268-34.0.tree,OLD
829,326,342,1902,3399,823,COIL20_old/11/COIL20-0.02230187840002973-29.0.tree,OLD
659,277,287,1551,2774,777,COIL20_old/11/COIL20-0.02581633318429044-19.0.tree,OLD
599,249,269,1409,2526,724,COIL20_old/11/COIL20-0.028052726078694523-12.0.tree,OLD
664,278,289,1561,2792,779,COIL20_old/11/COIL20-0.02579951933825142-20.0.tree,OLD
593,240,251,1364,2448,734,COIL20_old/11/COIL20-0.03178716977792717-9.0.tree,OLD
276,93,85,556,1010,384,COIL20_old/11/COIL20-0.017061535881958467-52.0.tree,OLD
529,183,167,1052,1931,589,COIL20_old/11/COIL20-0.057789351851851634-3.0.tree,OLD
569,231,227,1328,2355,731,COIL20_old/11/COIL20-0.013735619736939708-66.0.tree,OLD
845,329,347,1928,3449,829,COIL20_old/11/COIL20-0.022123924100156067-31.0.tree,OLD
1512,572,606,3348,6038,965,COIL20_old/7/COIL20-0.04304962879126556-6.0.tree,OLD
403,133,137,915,1588,551,COIL20_old/7/COIL20-0.010302532789328245-85.0.tree,OLD
373,120,121,826,1440,523,COIL20_old/7/COIL20-0.011524575694909722-75.0.tree,OLD
128,28,32,249,437,205,COIL20_old/7/COIL20-0.020181994746255705-39.0.tree,OLD
371,116,119,810,1416,517,COIL20_old/7/COIL20-0.013062867948431756-70.0.tree,OLD
349,115,128,786,1378,516,COIL20_old/7/COIL20-0.01807762081749764-43.0.tree,OLD
69,10,15,135,229,86,COIL20_old/7/COIL20-0.02339971542216207-35.0.tree,OLD
170,63,48,327,608,263,COIL20_old/7/COIL20-0.02514798280423225-28.0.tree,OLD
381,121,123,845,1470,530,COIL20_old/7/COIL20-0.011039209795811744-78.0.tree,OLD
394,130,131,887,1542,542,COIL20_old/7/COIL20-0.010644398800207955-82.0.tree,OLD
368,116,119,809,1412,517,COIL20_old/7/COIL20-0.013063252198375841-69.0.tree,OLD
330,103,113,726,1272,487,COIL20_old/7/COIL20-0.01602640146434192-51.0.tree,OLD
394,130,131,889,1544,543,COIL20_old/7/COIL20-0.01047382675683628-84.0.tree,OLD
367,116,119,806,1408,517,COIL20_old/7/COIL20-0.013571638162307609-66.0.tree,OLD
372,117,121,815,1425,523,COIL20_old/7/COIL20-0.012783844269319777-71.0.tree,OLD
379,121,123,841,1464,528,COIL20_old/7/COIL20-0.011409719893434811-76.0.tree,OLD
45,2,9,101,157,76,COIL20_old/7/COIL20-0.021706256054846773-37.0.tree,OLD
1162,448,488,2662,4760,925,COIL20_old/7/COIL20-0.031508600212385496-11.0.tree,OLD
367,116,119,804,1406,516,COIL20_old/7/COIL20-0.013917940513450966-64.0.tree,OLD
1203,445,491,2706,4845,919,COIL20_old/7/COIL20-0.027595363849764687-18.0.tree,OLD
120,25,31,238,414,198,COIL20_old/7/COIL20-0.02162312998360505-38.0.tree,OLD
381,121,123,846,1471,530,COIL20_old/7/COIL20-0.01098171203144871-79.0.tree,OLD
381,121,123,844,1469,529,COIL20_old/7/COIL20-0.011405062318354586-77.0.tree,OLD
367,116,119,805,1407,517,COIL20_old/7/COIL20-0.01383657267680144-65.0.tree,OLD
330,103,112,721,1266,485,COIL20_old/7/COIL20-0.016109690550710987-50.0.tree,OLD
1546,567,625,3430,6168,978,COIL20_old/7/COIL20-0.02614214220508254-22.0.tree,OLD
344,109,118,763,1334,495,COIL20_old/7/COIL20-0.01464995994485413-60.0.tree,OLD
1202,445,491,2705,4843,918,COIL20_old/7/COIL20-0.027982629573739037-17.0.tree,OLD
349,115,127,786,1377,517,COIL20_old/7/COIL20-0.01751220284671029-44.0.tree,OLD
1117,408,463,2524,4512,902,COIL20_old/7/COIL20-0.029267188780832565-15.0.tree,OLD
1182,476,469,2619,4746,916,COIL20_old/7/COIL20-0.03317914431030622-10.0.tree,OLD
349,130,157,832,1468,520,COIL20_old/7/COIL20-0.05335527051196115-4.0.tree,OLD
1205,442,487,2661,4795,915,COIL20_old/7/COIL20-0.029347485375214255-14.0.tree,OLD
348,116,126,778,1368,514,COIL20_old/7/COIL20-0.019491590748192122-41.0.tree,OLD
324,99,111,705,1239,479,COIL20_old/7/COIL20-0.016457762780385687-49.0.tree,OLD
372,117,121,817,1427,523,COIL20_old/7/COIL20-0.012434549426186214-73.0.tree,OLD
411,143,144,828,1526,500,COIL20_old/7/COIL20-0.046749431775839956-5.0.tree,OLD
324,99,111,701,1235,477,COIL20_old/7/COIL20-0.017393434682167697-45.0.tree,OLD
381,121,123,847,1472,531,COIL20_old/7/COIL20-0.010927171827259274-80.0.tree,OLD
1532,593,611,3388,6124,966,COIL20_old/7/COIL20-0.037333491690885845-7.0.tree,OLD
372,117,121,816,1426,523,COIL20_old/7/COIL20-0.0127669372717783-72.0.tree,OLD
348,116,126,779,1369,514,COIL20_old/7/COIL20-0.019014422181236057-42.0.tree,OLD
1169,465,455,2557,4646,910,COIL20_old/7/COIL20-0.034702124785751076-8.0.tree,OLD
368,116,119,808,1411,516,COIL20_old/7/COIL20-0.013197471868246657-68.0.tree,OLD
324,99,111,704,1238,478,COIL20_old/7/COIL20-0.017041263786422012-48.0.tree,OLD
1164,422,480,2619,4685,912,COIL20_old/7/COIL20-0.03098179353901248-13.0.tree,OLD
324,99,111,702,1236,477,COIL20_old/7/COIL20-0.017310180527609798-46.0.tree,OLD
373,120,121,825,1439,522,COIL20_old/7/COIL20-0.011629941687160472-74.0.tree,OLD
620,236,239,1339,2434,666,COIL20_old/7/COIL20-0.0667206712497202-3.0.tree,OLD
70,10,15,134,229,87,COIL20_old/7/COIL20-0.024593370407631876-34.0.tree,OLD
344,109,118,764,1335,496,COIL20_old/7/COIL20-0.014360316994559696-61.0.tree,OLD
344,109,118,765,1336,497,COIL20_old/7/COIL20-0.01413554242119397-62.0.tree,OLD
345,109,119,765,1338,497,COIL20_old/7/COIL20-0.014935888479022164-57.0.tree,OLD
345,109,119,766,1339,498,COIL20_old/7/COIL20-0.014930345964676572-58.0.tree,OLD
331,104,113,732,1280,491,COIL20_old/7/COIL20-0.014970890155749872-56.0.tree,OLD
345,109,119,767,1340,498,COIL20_old/7/COIL20-0.014747198468588074-59.0.tree,OLD
1205,446,492,2712,4855,920,COIL20_old/7/COIL20-0.028419032714808556-16.0.tree,OLD
396,130,131,889,1546,544,COIL20_old/7/COIL20-0.010744268853863925-81.0.tree,OLD
355,113,119,786,1373,509,COIL20_old/7/COIL20-0.013979397216633827-63.0.tree,OLD
147,36,46,304,533,246,COIL20_old/7/COIL20-0.020068454709740224-40.0.tree,OLD
297,104,126,615,1142,328,COIL20_old/7/COIL20-0.13254381613756644-1.0.tree,OLD
324,99,111,703,1237,477,COIL20_old/7/COIL20-0.017045467247932378-47.0.tree,OLD
1182,472,464,2602,4720,914,COIL20_old/7/COIL20-0.03392815224681478-9.0.tree,OLD
374,115,130,818,1437,513,COIL20_old/7/COIL20-0.015302788955958435-52.0.tree,OLD
394,130,131,888,1543,542,COIL20_old/7/COIL20-0.010586132535956028-83.0.tree,OLD
46,2,9,102,159,76,COIL20_old/7/COIL20-0.022021806766525598-36.0.tree,OLD
240,117,119,625,1101,299,COIL20_old/7/COIL20-0.08967533208510364-2.0.tree,OLD
367,116,119,807,1409,517,COIL20_old/7/COIL20-0.013510949959013141-67.0.tree,OLD
172,67,67,431,737,310,COIL20_old/29/COIL20-0.01798835839108709-61.0.tree,OLD
232,88,139,522,981,298,COIL20_old/29/COIL20-0.05518163378418606-4.0.tree,OLD
754,302,274,1632,2962,800,COIL20_old/29/COIL20-0.010231935595051533-105.0.tree,OLD
633,263,282,1476,2654,716,COIL20_old/29/COIL20-0.036250069863626444-12.0.tree,OLD
722,284,253,1531,2790,775,COIL20_old/29/COIL20-0.011192735114390229-97.0.tree,OLD
233,88,115,505,941,341,COIL20_old/29/COIL20-0.043881692935389405-7.0.tree,OLD
226,88,93,513,920,322,COIL20_old/29/COIL20-0.025721970713167563-23.0.tree,OLD
300,116,118,709,1243,493,COIL20_old/29/COIL20-0.013849835121842513-78.0.tree,OLD
723,289,259,1559,2830,777,COIL20_old/29/COIL20-0.010872596691258618-100.0.tree,OLD
211,60,56,366,693,289,COIL20_old/29/COIL20-0.023417647086221405-37.0.tree,OLD
734,293,267,1590,2884,786,COIL20_old/29/COIL20-0.010380593747670475-103.0.tree,OLD
748,294,302,1649,2993,751,COIL20_old/29/COIL20-0.03218416983381839-15.0.tree,OLD
296,115,114,690,1215,485,COIL20_old/29/COIL20-0.014544628884417599-75.0.tree,OLD
239,92,94,588,1013,408,COIL20_old/29/COIL20-0.017450082439079806-66.0.tree,OLD
170,67,58,393,688,291,COIL20_old/29/COIL20-0.021374764792458423-50.0.tree,OLD
721,284,253,1531,2789,775,COIL20_old/29/COIL20-0.01107607450257031-98.0.tree,OLD
170,67,58,392,687,290,COIL20_old/29/COIL20-0.02168896480736282-49.0.tree,OLD
213,82,94,487,876,287,COIL20_old/29/COIL20-0.02964676950592421-18.0.tree,OLD
720,284,253,1528,2785,775,COIL20_old/29/COIL20-0.011317919088605799-96.0.tree,OLD
380,150,138,861,1529,568,COIL20_old/29/COIL20-0.011932125158356954-91.0.tree,OLD
289,115,113,681,1198,482,COIL20_old/29/COIL20-0.015171387119010227-73.0.tree,OLD
300,116,118,708,1242,493,COIL20_old/29/COIL20-0.013953466167374806-77.0.tree,OLD
316,122,124,747,1309,508,COIL20_old/29/COIL20-0.012508220620015442-87.0.tree,OLD
216,87,86,528,917,388,COIL20_old/29/COIL20-0.016291941463595472-67.0.tree,OLD
307,117,166,722,1312,369,COIL20_old/29/COIL20-0.08151652973395906-2.0.tree,OLD
752,301,274,1628,2955,798,COIL20_old/29/COIL20-0.01024236856323113-104.0.tree,OLD
173,67,61,410,711,299,COIL20_old/29/COIL20-0.020344602336240136-55.0.tree,OLD
184,72,71,463,790,325,COIL20_old/29/COIL20-0.01759468850137902-64.0.tree,OLD
308,118,121,719,1266,495,COIL20_old/29/COIL20-0.013341414226097414-81.0.tree,OLD
615,250,267,1401,2533,682,COIL20_old/29/COIL20-0.036763078470824995-11.0.tree,OLD
218,89,88,535,930,394,COIL20_old/29/COIL20-0.016032561107385435-68.0.tree,OLD
279,111,107,653,1150,463,COIL20_old/29/COIL20-0.015679400476935557-71.0.tree,OLD
217,84,88,485,874,302,COIL20_old/29/COIL20-0.025983097660033927-22.0.tree,OLD
734,293,267,1589,2883,786,COIL20_old/29/COIL20-0.01044759296519876-102.0.tree,OLD
289,114,113,681,1197,482,COIL20_old/29/COIL20-0.014588293650793283-74.0.tree,OLD
289,115,113,680,1197,481,COIL20_old/29/COIL20-0.015284077148073949-72.0.tree,OLD
170,67,58,391,686,289,COIL20_old/29/COIL20-0.02227574940383048-48.0.tree,OLD
302,116,119,708,1245,491,COIL20_old/29/COIL20-0.01413193280050662-76.0.tree,OLD
150,63,54,369,636,291,COIL20_old/29/COIL20-0.019614015109172933-59.0.tree,OLD
186,76,87,444,793,279,COIL20_old/29/COIL20-0.028147496087636337-19.0.tree,OLD
636,263,282,1479,2660,718,COIL20_old/29/COIL20-0.035110826999031675-13.0.tree,OLD
172,68,66,430,736,307,COIL20_old/29/COIL20-0.018618900905432167-60.0.tree,OLD
206,73,90,451,820,274,COIL20_old/29/COIL20-0.030333342648483752-17.0.tree,OLD
150,63,54,367,634,289,COIL20_old/29/COIL20-0.01976873975333443-57.0.tree,OLD
148,62,79,317,606,200,COIL20_old/29/COIL20-0.041252119196661385-8.0.tree,OLD
735,293,265,1583,2876,782,COIL20_old/29/COIL20-0.010760908040837791-101.0.tree,OLD
312,120,122,732,1286,500,COIL20_old/29/COIL20-0.013161655115880466-83.0.tree,OLD
634,262,280,1456,2632,692,COIL20_old/29/COIL20-0.03360365899098289-14.0.tree,OLD
173,66,61,408,708,298,COIL20_old/29/COIL20-0.020629436340264096-54.0.tree,OLD
220,83,91,507,901,316,COIL20_old/29/COIL20-0.024800911953200944-26.0.tree,OLD
380,150,138,863,1531,569,COIL20_old/29/COIL20-0.011640747261346507-93.0.tree,OLD
721,284,253,1532,2790,775,COIL20_old/29/COIL20-0.011029009706385595-99.0.tree,OLD
204,81,90,497,872,310,COIL20_old/29/COIL20-0.023859010544750148-27.0.tree,OLD
177,76,105,434,792,219,COIL20_old/29/COIL20-0.14088776874208192-1.0.tree,OLD
308,118,121,718,1265,495,COIL20_old/29/COIL20-0.013485577818764305-80.0.tree,OLD
226,88,93,514,921,323,COIL20_old/29/COIL20-0.025271443475668454-24.0.tree,OLD
213,58,57,369,697,290,COIL20_old/29/COIL20-0.022408990982933363-38.0.tree,OLD
223,84,90,495,892,311,COIL20_old/29/COIL20-0.026547351237052597-21.0.tree,OLD
232,94,90,551,967,407,COIL20_old/29/COIL20-0.01587953647812773-69.0.tree,OLD
352,127,165,799,1443,459,COIL20_old/29/COIL20-0.038435799985095775-9.0.tree,OLD
223,84,93,511,911,321,COIL20_old/29/COIL20-0.024820718291229005-25.0.tree,OLD
383,150,138,866,1537,570,COIL20_old/29/COIL20-0.011595196177062728-94.0.tree,OLD
220,87,89,494,890,311,COIL20_old/29/COIL20-0.026605885311871746-20.0.tree,OLD
249,94,128,544,1015,340,COIL20_old/29/COIL20-0.05068517587003579-5.0.tree,OLD
173,66,61,407,707,298,COIL20_old/29/COIL20-0.020646285118116336-53.0.tree,OLD
316,122,124,749,1311,510,COIL20_old/29/COIL20-0.01214171603696268-89.0.tree,OLD
718,284,252,1521,2775,773,COIL20_old/29/COIL20-0.01143156392056005-95.0.tree,OLD
233,94,90,552,969,408,COIL20_old/29/COIL20-0.015813573571056727-70.0.tree,OLD
171,67,59,399,696,297,COIL20_old/29/COIL20-0.021260852149936282-52.0.tree,OLD
210,83,128,506,927,303,COIL20_old/29/COIL20-0.04735893369476085-6.0.tree,OLD
150,63,54,368,635,291,COIL20_old/29/COIL20-0.019652521611149554-58.0.tree,OLD
171,67,59,398,695,296,COIL20_old/29/COIL20-0.021325825322303815-51.0.tree,OLD
188,73,72,471,804,331,COIL20_old/29/COIL20-0.017450629704151288-65.0.tree,OLD
380,150,138,862,1530,569,COIL20_old/29/COIL20-0.011776434067366948-92.0.tree,OLD
308,120,121,726,1275,499,COIL20_old/29/COIL20-0.012881490330873324-84.0.tree,OLD
301,116,118,711,1246,493,COIL20_old/29/COIL20-0.013511439004395498-79.0.tree,OLD
316,122,124,748,1310,509,COIL20_old/29/COIL20-0.012181643099337225-88.0.tree,OLD
315,122,123,749,1309,511,COIL20_old/29/COIL20-0.012006320329383313-90.0.tree,OLD
308,118,121,720,1267,496,COIL20_old/29/COIL20-0.013315692767716936-82.0.tree,OLD
308,120,121,727,1276,500,COIL20_old/29/COIL20-0.012758425553319797-85.0.tree,OLD
316,122,123,742,1303,506,COIL20_old/29/COIL20-0.012697015425888858-86.0.tree,OLD
150,63,54,366,633,288,COIL20_old/29/COIL20-0.019969888777106592-56.0.tree,OLD
354,132,170,822,1478,474,COIL20_old/29/COIL20-0.03720547823980974-10.0.tree,OLD
235,85,160,523,1003,281,COIL20_old/29/COIL20-0.07138304363216413-3.0.tree,OLD
299,125,113,727,1264,488,COIL20_old/16/COIL20-0.014823000503017936-55.0.tree,OLD
98,36,28,240,402,178,COIL20_old/16/COIL20-0.01810626490423972-44.0.tree,OLD
370,147,111,787,1415,503,COIL20_old/16/COIL20-0.011826502999478516-70.0.tree,OLD
99,38,26,240,403,179,COIL20_old/16/COIL20-0.017510561051494344-45.0.tree,OLD
907,349,400,2051,3707,836,COIL20_old/16/COIL20-0.024803590058871783-20.0.tree,OLD
135,57,77,346,615,213,COIL20_old/16/COIL20-0.13405749310678833-1.0.tree,OLD
355,141,100,741,1337,484,COIL20_old/16/COIL20-0.011796275337207451-72.0.tree,OLD
372,148,108,777,1405,502,COIL20_old/16/COIL20-0.011055231854087078-81.0.tree,OLD
49,24,13,134,220,92,COIL20_old/16/COIL20-0.023349215664356493-34.0.tree,OLD
89,37,27,235,388,180,COIL20_old/16/COIL20-0.017220696866384166-48.0.tree,OLD
980,372,431,2210,3993,865,COIL20_old/16/COIL20-0.02535520996348506-12.0.tree,OLD
239,112,97,622,1070,437,COIL20_old/16/COIL20-0.016645148669796495-50.0.tree,OLD
87,36,24,224,371,169,COIL20_old/16/COIL20-0.017416175292495895-46.0.tree,OLD
357,148,123,830,1458,533,COIL20_old/16/COIL20-0.013088461323495892-63.0.tree,OLD
372,148,108,778,1406,503,COIL20_old/16/COIL20-0.011053275672553875-82.0.tree,OLD
247,111,101,644,1103,441,COIL20_old/16/COIL20-0.015972641403980303-53.0.tree,OLD
366,147,104,766,1383,496,COIL20_old/16/COIL20-0.011378851814591529-76.0.tree,OLD
335,138,120,780,1373,520,COIL20_old/16/COIL20-0.014337005831283223-56.0.tree,OLD
364,149,124,833,1470,535,COIL20_old/16/COIL20-0.012778977103360789-64.0.tree,OLD
88,37,26,227,378,170,COIL20_old/16/COIL20-0.018324367501304062-42.0.tree,OLD
907,349,400,2050,3706,835,COIL20_old/16/COIL20-0.02491379992920456-19.0.tree,OLD
676,298,308,1677,2959,774,COIL20_old/16/COIL20-0.03817647784857259-5.0.tree,OLD
722,264,333,1646,2965,759,COIL20_old/16/COIL20-0.026298951114091973-9.0.tree,OLD
346,139,116,780,1381,520,COIL20_old/16/COIL20-0.013221260432967563-62.0.tree,OLD
88,37,26,228,379,171,COIL20_old/16/COIL20-0.018297365209776928-43.0.tree,OLD
579,222,291,1421,2513,680,COIL20_old/16/COIL20-0.030513264773827486-6.0.tree,OLD
219,95,93,578,985,414,COIL20_old/16/COIL20-0.015667814758923426-54.0.tree,OLD
372,148,108,776,1404,501,COIL20_old/16/COIL20-0.011094623295327288-80.0.tree,OLD
980,366,419,2185,3950,865,COIL20_old/16/COIL20-0.025736444127729963-11.0.tree,OLD
339,139,159,828,1465,432,COIL20_old/16/COIL20-0.04782619327073595-3.0.tree,OLD
894,336,405,2035,3670,827,COIL20_old/16/COIL20-0.025006602112676468-17.0.tree,OLD
362,143,106,760,1371,495,COIL20_old/16/COIL20-0.011949288322526896-67.0.tree,OLD
342,139,99,722,1302,478,COIL20_old/16/COIL20-0.011213170225054359-77.0.tree,OLD
672,221,318,1621,2832,734,COIL20_old/16/COIL20-0.02399359117668992-27.0.tree,OLD
56,22,13,143,234,101,COIL20_old/16/COIL20-0.01916009948580283-40.0.tree,OLD
384,151,111,811,1457,519,COIL20_old/16/COIL20-0.010998351218421076-83.0.tree,OLD
324,134,115,752,1325,502,COIL20_old/16/COIL20-0.013938655078619022-57.0.tree,OLD
340,139,115,769,1363,517,COIL20_old/16/COIL20-0.013368544600939225-61.0.tree,OLD
363,144,106,762,1375,495,COIL20_old/16/COIL20-0.011937306710633644-68.0.tree,OLD
89,37,27,234,387,179,COIL20_old/16/COIL20-0.017381010600641678-47.0.tree,OLD
366,147,104,765,1382,495,COIL20_old/16/COIL20-0.011530618898576317-75.0.tree,OLD
49,19,13,135,216,96,COIL20_old/16/COIL20-0.01904639643416034-41.0.tree,OLD
336,140,116,768,1360,512,COIL20_old/16/COIL20-0.01340475724718665-60.0.tree,OLD
482,189,218,1089,1978,585,COIL20_old/16/COIL20-0.026948438315075873-8.0.tree,OLD
356,143,103,750,1352,491,COIL20_old/16/COIL20-0.01181915567478986-71.0.tree,OLD
372,151,127,856,1506,544,COIL20_old/16/COIL20-0.012677081004545787-65.0.tree,OLD
240,113,97,624,1074,441,COIL20_old/16/COIL20-0.016930646378270187-49.0.tree,OLD
52,21,13,139,225,98,COIL20_old/16/COIL20-0.0198018551121536-39.0.tree,OLD
654,251,284,1452,2641,688,COIL20_old/16/COIL20-0.04394252086593675-4.0.tree,OLD
907,349,400,2052,3708,836,COIL20_old/16/COIL20-0.02474864231686469-21.0.tree,OLD
247,111,101,642,1101,441,COIL20_old/16/COIL20-0.016342569304716947-51.0.tree,OLD
88,35,31,236,390,174,COIL20_old/16/COIL20-0.02121976069379139-36.0.tree,OLD
363,150,103,761,1377,490,COIL20_old/16/COIL20-0.01162240805946807-73.0.tree,OLD
52,21,13,137,223,96,COIL20_old/16/COIL20-0.021121683806542224-37.0.tree,OLD
49,24,13,135,221,93,COIL20_old/16/COIL20-0.02244555294731343-35.0.tree,OLD
336,140,116,766,1358,512,COIL20_old/16/COIL20-0.013800662772933736-58.0.tree,OLD
364,147,103,763,1377,493,COIL20_old/16/COIL20-0.011546443009911811-74.0.tree,OLD
354,143,102,741,1340,484,COIL20_old/16/COIL20-0.011145681962143383-79.0.tree,OLD
365,146,109,775,1395,501,COIL20_old/16/COIL20-0.011895085792532623-69.0.tree,OLD
361,145,110,779,1395,512,COIL20_old/16/COIL20-0.012147328414933878-66.0.tree,OLD
956,364,404,2126,3850,856,COIL20_old/16/COIL20-0.02529682725985455-14.0.tree,OLD
348,143,100,732,1323,480,COIL20_old/16/COIL20-0.011146986083165944-78.0.tree,OLD
543,192,249,1237,2221,636,COIL20_old/16/COIL20-0.02846565504135956-7.0.tree,OLD
276,119,146,716,1257,356,COIL20_old/16/COIL20-0.0811845727140626-2.0.tree,OLD
247,111,101,643,1102,441,COIL20_old/16/COIL20-0.016306077203964653-52.0.tree,OLD
978,368,423,2192,3961,865,COIL20_old/16/COIL20-0.025756821018704135-10.0.tree,OLD
52,21,13,138,224,97,COIL20_old/16/COIL20-0.020215249832327642-38.0.tree,OLD
336,140,116,767,1359,512,COIL20_old/16/COIL20-0.013594902749832105-59.0.tree,OLD
234,81,75,519,909,342,COIL20_old/6/COIL20-0.012086651855576391-75.0.tree,OLD
134,53,44,333,564,182,COIL20_old/6/COIL20-0.019250619457486018-43.0.tree,OLD
117,51,35,287,490,183,COIL20_old/6/COIL20-0.014127403308741626-63.0.tree,OLD
77,37,20,199,333,135,COIL20_old/6/COIL20-0.015237606192711306-57.0.tree,OLD
64,30,13,153,260,94,COIL20_old/6/COIL20-0.01797202194649361-48.0.tree,OLD
216,84,79,461,840,308,COIL20_old/6/COIL20-0.05132780479171323-4.0.tree,OLD
201,71,61,446,779,300,COIL20_old/6/COIL20-0.013875603155972749-65.0.tree,OLD
78,37,21,200,336,135,COIL20_old/6/COIL20-0.015892985226172607-54.0.tree,OLD
77,37,20,198,332,133,COIL20_old/6/COIL20-0.015726069379239038-56.0.tree,OLD
126,51,39,311,527,176,COIL20_old/6/COIL20-0.018559260656532295-46.0.tree,OLD
748,248,324,1647,2967,784,COIL20_old/6/COIL20-0.03575935939712299-6.0.tree,OLD
83,44,23,222,372,135,COIL20_old/6/COIL20-0.014443280050672913-60.0.tree,OLD
401,155,174,960,1690,520,COIL20_old/6/COIL20-0.031291662009091115-8.0.tree,OLD
245,82,77,532,936,353,COIL20_old/6/COIL20-0.012057309132573524-77.0.tree,OLD
136,49,40,324,549,185,COIL20_old/6/COIL20-0.023329944947463432-37.0.tree,OLD
216,78,67,484,845,316,COIL20_old/6/COIL20-0.012554493628436525-71.0.tree,OLD
369,173,167,882,1591,463,COIL20_old/6/COIL20-0.06266323636261978-3.0.tree,OLD
110,36,37,277,460,188,COIL20_old/6/COIL20-0.024435839574484808-36.0.tree,OLD
201,71,61,447,780,301,COIL20_old/6/COIL20-0.013807334749237121-66.0.tree,OLD
407,142,167,894,1610,524,COIL20_old/6/COIL20-0.028055578843431073-13.0.tree,OLD
109,50,34,278,471,180,COIL20_old/6/COIL20-0.01442390453834097-61.0.tree,OLD
459,187,199,1016,1861,577,COIL20_old/6/COIL20-0.03963800162083597-5.0.tree,OLD
376,121,152,803,1452,483,COIL20_old/6/COIL20-0.027098132778150485-15.0.tree,OLD
216,78,67,485,846,317,COIL20_old/6/COIL20-0.012383805145688764-72.0.tree,OLD
77,37,20,197,331,132,COIL20_old/6/COIL20-0.015860801382367617-55.0.tree,OLD
142,50,45,346,583,192,COIL20_old/6/COIL20-0.01959503549072189-42.0.tree,OLD
142,54,42,333,571,192,COIL20_old/6/COIL20-0.021744552965943298-39.0.tree,OLD
216,78,67,487,848,318,COIL20_old/6/COIL20-0.012359317944705128-74.0.tree,OLD
117,51,35,288,491,184,COIL20_old/6/COIL20-0.013956889485058022-64.0.tree,OLD
259,86,79,559,983,369,COIL20_old/6/COIL20-0.01037842797525812-85.0.tree,OLD
251,84,78,544,957,359,COIL20_old/6/COIL20-0.011954795905059434-78.0.tree,OLD
145,55,42,337,579,198,COIL20_old/6/COIL20-0.021522933899695118-40.0.tree,OLD
251,84,78,546,959,360,COIL20_old/6/COIL20-0.011064337413369096-80.0.tree,OLD
65,32,13,156,266,96,COIL20_old/6/COIL20-0.01749530749310607-49.0.tree,OLD
61,32,13,157,263,96,COIL20_old/6/COIL20-0.016863146471421453-51.0.tree,OLD
393,135,159,865,1552,522,COIL20_old/6/COIL20-0.028813983437662505-12.0.tree,OLD
77,37,20,200,334,136,COIL20_old/6/COIL20-0.014893190159475267-58.0.tree,OLD
403,140,173,955,1671,501,COIL20_old/6/COIL20-0.030364757992399738-9.0.tree,OLD
462,150,192,1007,1811,574,COIL20_old/6/COIL20-0.025651326943140373-18.0.tree,OLD
201,71,61,450,783,304,COIL20_old/6/COIL20-0.012926598945524559-69.0.tree,OLD
151,57,43,347,598,198,COIL20_old/6/COIL20-0.02220498919442504-38.0.tree,OLD
216,78,67,486,847,317,COIL20_old/6/COIL20-0.012374047525895882-73.0.tree,OLD
142,54,44,342,582,184,COIL20_old/6/COIL20-0.01914499729860708-44.0.tree,OLD
466,149,193,1014,1822,574,COIL20_old/6/COIL20-0.025329465217228397-20.0.tree,OLD
562,202,240,1295,2299,648,COIL20_old/6/COIL20-0.027849748956703113-14.0.tree,OLD
387,149,142,846,1524,504,COIL20_old/6/COIL20-0.02478143164542801-28.0.tree,OLD
251,84,78,547,960,360,COIL20_old/6/COIL20-0.010762410108800913-81.0.tree,OLD
245,82,77,531,935,352,COIL20_old/6/COIL20-0.01206167560921062-76.0.tree,OLD
462,150,192,1008,1812,574,COIL20_old/6/COIL20-0.025407793986138627-19.0.tree,OLD
251,84,78,545,958,359,COIL20_old/6/COIL20-0.011428757731574923-79.0.tree,OLD
462,150,193,1010,1815,577,COIL20_old/6/COIL20-0.026515365340189057-16.0.tree,OLD
140,54,42,334,570,196,COIL20_old/6/COIL20-0.020524943643342564-41.0.tree,OLD
150,54,78,345,627,175,COIL20_old/6/COIL20-0.1343182241597733-1.0.tree,OLD
214,78,67,480,839,314,COIL20_old/6/COIL20-0.012889594511514058-70.0.tree,OLD
443,208,197,1059,1907,529,COIL20_old/6/COIL20-0.0760221630710185-2.0.tree,OLD
430,145,172,935,1682,540,COIL20_old/6/COIL20-0.029681841046277913-10.0.tree,OLD
83,44,23,221,371,134,COIL20_old/6/COIL20-0.014559626276175519-59.0.tree,OLD
259,86,79,556,980,368,COIL20_old/6/COIL20-0.010723239902376669-82.0.tree,OLD
201,71,61,449,782,303,COIL20_old/6/COIL20-0.013156275616662494-68.0.tree,OLD
460,150,194,1011,1815,570,COIL20_old/6/COIL20-0.025945708976079118-17.0.tree,OLD
64,30,13,152,259,93,COIL20_old/6/COIL20-0.018410800450852915-47.0.tree,OLD
259,86,79,557,981,368,COIL20_old/6/COIL20-0.010572590636411083-83.0.tree,OLD
69,35,15,170,289,107,COIL20_old/6/COIL20-0.016862867016916416-52.0.tree,OLD
415,144,168,910,1637,529,COIL20_old/6/COIL20-0.029164186507936174-11.0.tree,OLD
69,35,15,171,290,108,COIL20_old/6/COIL20-0.016507773492808686-53.0.tree,OLD
491,160,196,1073,1920,594,COIL20_old/6/COIL20-0.03339483661226578-7.0.tree,OLD
201,71,61,448,781,302,COIL20_old/6/COIL20-0.01352665763097094-67.0.tree,OLD
61,32,13,156,262,95,COIL20_old/6/COIL20-0.01706660099485774-50.0.tree,OLD
129,51,40,312,532,175,COIL20_old/6/COIL20-0.018783383169386547-45.0.tree,OLD
109,50,34,279,472,181,COIL20_old/6/COIL20-0.01440098926894684-62.0.tree,OLD
259,86,79,558,982,368,COIL20_old/6/COIL20-0.010492294042029338-84.0.tree,OLD
265,104,100,656,1125,468,COIL20_old/28/COIL20-0.020878127561666404-45.0.tree,OLD
755,273,286,1704,3018,834,COIL20_old/28/COIL20-0.011633411580594555-88.0.tree,OLD
267,104,101,664,1136,473,COIL20_old/28/COIL20-0.019968864110589235-49.0.tree,OLD
621,239,230,1380,2470,705,COIL20_old/28/COIL20-0.04715799426186773-7.0.tree,OLD
645,235,254,1499,2633,789,COIL20_old/28/COIL20-0.012501141105894509-81.0.tree,OLD
309,124,123,674,1230,432,COIL20_old/28/COIL20-0.05883530348759247-4.0.tree,OLD
61,6,11,83,161,46,COIL20_old/28/COIL20-0.03719391580967346-15.0.tree,OLD
489,174,196,1164,2023,680,COIL20_old/28/COIL20-0.014242981034353785-72.0.tree,OLD
645,235,254,1500,2634,789,COIL20_old/28/COIL20-0.012414754732096522-82.0.tree,OLD
490,174,195,1159,2018,677,COIL20_old/28/COIL20-0.014817003875101709-69.0.tree,OLD
644,235,254,1494,2627,787,COIL20_old/28/COIL20-0.013356737648110961-76.0.tree,OLD
493,175,196,1167,2031,680,COIL20_old/28/COIL20-0.013543879014829563-73.0.tree,OLD
481,183,197,1156,2017,674,COIL20_old/28/COIL20-0.015935671901781634-65.0.tree,OLD
645,235,254,1497,2631,788,COIL20_old/28/COIL20-0.012650917076532098-79.0.tree,OLD
487,177,192,1151,2007,665,COIL20_old/28/COIL20-0.015135442283330192-67.0.tree,OLD
447,172,186,1093,1898,651,COIL20_old/28/COIL20-0.01795875950145326-59.0.tree,OLD
465,190,178,1046,1879,615,COIL20_old/28/COIL20-0.05064905637528927-6.0.tree,OLD
147,42,56,310,555,198,COIL20_old/28/COIL20-0.02481288192115655-28.0.tree,OLD
61,6,11,82,160,45,COIL20_old/28/COIL20-0.03881426289216855-14.0.tree,OLD
755,273,286,1705,3019,834,COIL20_old/28/COIL20-0.011254587711453712-89.0.tree,OLD
489,174,196,1162,2021,678,COIL20_old/28/COIL20-0.014454574670243803-70.0.tree,OLD
267,104,101,666,1138,475,COIL20_old/28/COIL20-0.019826819714584165-51.0.tree,OLD
505,175,200,1183,2063,685,COIL20_old/28/COIL20-0.013532188501378606-74.0.tree,OLD
1197,482,446,2643,4768,923,COIL20_old/28/COIL20-0.04096433927639853-11.0.tree,OLD
645,235,254,1498,2632,789,COIL20_old/28/COIL20-0.012572960913630193-80.0.tree,OLD
19,5,6,50,80,31,COIL20_old/28/COIL20-0.03141250279454488-19.0.tree,OLD
442,169,183,1079,1873,648,COIL20_old/28/COIL20-0.018607524778299633-56.0.tree,OLD
1200,486,445,2649,4780,925,COIL20_old/28/COIL20-0.03936336770623722-12.0.tree,OLD
270,104,102,674,1150,477,COIL20_old/28/COIL20-0.01893818932111152-53.0.tree,OLD
806,304,315,1799,3224,813,COIL20_old/28/COIL20-0.041858954653848535-9.0.tree,OLD
129,38,51,265,483,191,COIL20_old/28/COIL20-0.02728845293986143-26.0.tree,OLD
645,235,254,1502,2636,790,COIL20_old/28/COIL20-0.011940124543558917-84.0.tree,OLD
127,46,36,234,443,197,COIL20_old/28/COIL20-0.03339095918101226-18.0.tree,OLD
481,183,197,1154,2015,673,COIL20_old/28/COIL20-0.016949521201281625-63.0.tree,OLD
17,4,7,54,82,40,COIL20_old/28/COIL20-0.030363302500186595-20.0.tree,OLD
645,235,254,1501,2635,790,COIL20_old/28/COIL20-0.012093568354571316-83.0.tree,OLD
446,171,188,1093,1898,649,COIL20_old/28/COIL20-0.01743921864520387-61.0.tree,OLD
805,305,316,1802,3228,816,COIL20_old/28/COIL20-0.04415629191817566-8.0.tree,OLD
443,169,183,1081,1876,647,COIL20_old/28/COIL20-0.018244827762874727-57.0.tree,OLD
264,104,100,652,1120,466,COIL20_old/28/COIL20-0.022737350026083403-43.0.tree,OLD
442,169,183,1078,1872,648,COIL20_old/28/COIL20-0.018700140658768072-55.0.tree,OLD
482,177,191,1146,1996,664,COIL20_old/28/COIL20-0.015213072415976803-66.0.tree,OLD
267,104,101,665,1137,474,COIL20_old/28/COIL20-0.019829253297563243-50.0.tree,OLD
490,177,192,1154,2013,667,COIL20_old/28/COIL20-0.014971309337507177-68.0.tree,OLD
144,55,49,338,586,263,COIL20_old/28/COIL20-0.023265227941723865-40.0.tree,OLD
267,104,101,662,1134,472,COIL20_old/28/COIL20-0.020488544694090005-47.0.tree,OLD
132,38,52,265,487,188,COIL20_old/28/COIL20-0.027952075881212735-25.0.tree,OLD
237,100,94,612,1043,445,COIL20_old/28/COIL20-0.022776287353752034-41.0.tree,OLD
264,104,100,653,1121,466,COIL20_old/28/COIL20-0.021193585121841496-44.0.tree,OLD
503,175,199,1181,2058,685,COIL20_old/28/COIL20-0.013371106267232924-75.0.tree,OLD
269,104,102,672,1147,476,COIL20_old/28/COIL20-0.019231034354273646-52.0.tree,OLD
94,23,28,163,308,122,COIL20_old/28/COIL20-0.03514407044116563-16.0.tree,OLD
396,162,157,896,1611,551,COIL20_old/28/COIL20-0.053225242659662164-5.0.tree,OLD
443,169,183,1082,1877,647,COIL20_old/28/COIL20-0.0180836989529769-58.0.tree,OLD
489,174,196,1163,2022,679,COIL20_old/28/COIL20-0.014298021927862947-71.0.tree,OLD
264,104,100,651,1119,466,COIL20_old/28/COIL20-0.022761196810492434-42.0.tree,OLD
265,104,100,657,1126,469,COIL20_old/28/COIL20-0.020489417989417613-46.0.tree,OLD
756,274,286,1704,3020,833,COIL20_old/28/COIL20-0.011875966446829422-85.0.tree,OLD
152,43,60,322,577,196,COIL20_old/28/COIL20-0.026911096206869822-27.0.tree,OLD
447,172,186,1094,1899,651,COIL20_old/28/COIL20-0.017637200517922724-60.0.tree,OLD
167,81,75,431,754,227,COIL20_old/28/COIL20-0.12682468654519724-1.0.tree,OLD
645,235,254,1496,2630,787,COIL20_old/28/COIL20-0.012690995510097947-78.0.tree,OLD
481,183,197,1155,2016,674,COIL20_old/28/COIL20-0.016278399564050083-64.0.tree,OLD
132,38,53,268,491,191,COIL20_old/28/COIL20-0.02823674687010924-24.0.tree,OLD
267,104,101,663,1135,472,COIL20_old/28/COIL20-0.02015361847008068-48.0.tree,OLD
413,155,172,1007,1747,623,COIL20_old/28/COIL20-0.018856402302704744-54.0.tree,OLD
757,274,286,1705,3022,834,COIL20_old/28/COIL20-0.011851805276100913-86.0.tree,OLD
243,91,101,538,973,341,COIL20_old/28/COIL20-0.06926281066025813-3.0.tree,OLD
307,139,138,744,1328,398,COIL20_old/28/COIL20-0.07719278634771592-2.0.tree,OLD
480,183,197,1153,2013,672,COIL20_old/28/COIL20-0.01729165502272928-62.0.tree,OLD
645,235,254,1495,2629,787,COIL20_old/28/COIL20-0.012943622382443176-77.0.tree,OLD
755,273,286,1703,3017,834,COIL20_old/28/COIL20-0.011819749515613098-87.0.tree,OLD
1452,533,559,3202,5746,975,COIL20_old/17/COIL20-0.018081777703256974-75.0.tree,OLD
1467,532,567,3232,5798,979,COIL20_old/17/COIL20-0.01517286589909883-89.0.tree,OLD
409,144,147,861,1561,511,COIL20_old/17/COIL20-0.02331377151799613-23.0.tree,OLD
552,163,236,1217,2168,578,COIL20_old/17/COIL20-0.03423127887696481-5.0.tree,OLD
426,148,148,885,1607,522,COIL20_old/17/COIL20-0.021819889242863877-28.0.tree,OLD
1294,486,510,2902,5192,961,COIL20_old/17/COIL20-0.02034778113123259-60.0.tree,OLD
435,145,151,903,1634,519,COIL20_old/17/COIL20-0.025006602112675247-19.0.tree,OLD
407,142,147,851,1547,508,COIL20_old/17/COIL20-0.024243470079736817-20.0.tree,OLD
434,148,150,900,1632,528,COIL20_old/17/COIL20-0.02169213195841685-29.0.tree,OLD
1497,542,572,3279,5890,985,COIL20_old/17/COIL20-0.013724045662866835-99.0.tree,OLD
433,145,150,899,1627,515,COIL20_old/17/COIL20-0.025140006706907858-18.0.tree,OLD
417,145,148,871,1581,513,COIL20_old/17/COIL20-0.02306229739548421-24.0.tree,OLD
1468,532,567,3234,5801,979,COIL20_old/17/COIL20-0.014972136057082808-91.0.tree,OLD
1434,526,555,3172,5687,974,COIL20_old/17/COIL20-0.017192879499218106-77.0.tree,OLD
584,191,242,1258,2275,608,COIL20_old/17/COIL20-0.03860148157463328-4.0.tree,OLD
1497,542,572,3285,5896,985,COIL20_old/17/COIL20-0.012935005868543514-105.0.tree,OLD
1447,528,565,3205,5745,976,COIL20_old/17/COIL20-0.016647896639093884-80.0.tree,OLD
1491,541,569,3265,5866,984,COIL20_old/17/COIL20-0.014049074539830897-97.0.tree,OLD
409,144,147,860,1560,510,COIL20_old/17/COIL20-0.023520148669796237-22.0.tree,OLD
1322,493,520,2952,5287,962,COIL20_old/17/COIL20-0.019353598442506892-64.0.tree,OLD
425,147,148,881,1601,518,COIL20_old/17/COIL20-0.022190969893434-26.0.tree,OLD
1466,533,566,3234,5799,980,COIL20_old/17/COIL20-0.014758132126090506-92.0.tree,OLD
438,154,156,920,1668,524,COIL20_old/17/COIL20-0.026546105335718773-15.0.tree,OLD
1305,488,510,2912,5215,961,COIL20_old/17/COIL20-0.020310636969968543-61.0.tree,OLD
1504,541,572,3294,5911,986,COIL20_old/17/COIL20-0.012246208733884989-110.0.tree,OLD
1466,531,569,3241,5807,979,COIL20_old/17/COIL20-0.01637255244429453-82.0.tree,OLD
1340,495,523,2983,5341,965,COIL20_old/17/COIL20-0.01860835149787593-71.0.tree,OLD
1294,486,510,2901,5191,961,COIL20_old/17/COIL20-0.020384692413741357-59.0.tree,OLD
1489,541,569,3258,5857,983,COIL20_old/17/COIL20-0.014758062262464344-93.0.tree,OLD
1497,542,572,3282,5893,985,COIL20_old/17/COIL20-0.013364771965124755-102.0.tree,OLD
1504,541,572,3296,5913,986,COIL20_old/17/COIL20-0.012006623071764255-112.0.tree,OLD
1489,541,569,3261,5860,984,COIL20_old/17/COIL20-0.014114245659139546-96.0.tree,OLD
1497,542,572,3283,5894,985,COIL20_old/17/COIL20-0.013303047451375227-103.0.tree,OLD
1491,540,570,3272,5873,985,COIL20_old/17/COIL20-0.012574358186153156-107.0.tree,OLD
1287,483,507,2884,5161,961,COIL20_old/17/COIL20-0.021489702101498254-56.0.tree,OLD
425,147,148,882,1602,519,COIL20_old/17/COIL20-0.021971726190475827-27.0.tree,OLD
914,303,361,1894,3472,809,COIL20_old/17/COIL20-0.026843002459199905-12.0.tree,OLD
1330,494,522,2970,5316,964,COIL20_old/17/COIL20-0.019109040818988066-67.0.tree,OLD
1446,528,565,3204,5743,976,COIL20_old/17/COIL20-0.016653066547432538-79.0.tree,OLD
1466,531,566,3222,5785,978,COIL20_old/17/COIL20-0.01614686964378864-83.0.tree,OLD
1447,528,565,3206,5746,976,COIL20_old/17/COIL20-0.01659287903346096-81.0.tree,OLD
1287,483,507,2885,5162,961,COIL20_old/17/COIL20-0.021067551140175222-57.0.tree,OLD
1502,541,572,3291,5906,986,COIL20_old/17/COIL20-0.012529796836574625-108.0.tree,OLD
1340,495,523,2984,5342,965,COIL20_old/17/COIL20-0.018279561629033547-72.0.tree,OLD
1468,532,567,3233,5800,979,COIL20_old/17/COIL20-0.014992675963185709-90.0.tree,OLD
1503,541,572,3293,5909,986,COIL20_old/17/COIL20-0.012503830855503328-109.0.tree,OLD
1452,533,559,3201,5745,975,COIL20_old/17/COIL20-0.018093444928832414-74.0.tree,OLD
1497,542,572,3286,5897,985,COIL20_old/17/COIL20-0.01278528811759394-106.0.tree,OLD
1340,495,523,2982,5340,965,COIL20_old/17/COIL20-0.018730496404352148-70.0.tree,OLD
1497,541,571,3274,5883,985,COIL20_old/17/COIL20-0.013768467285193098-98.0.tree,OLD
1497,542,572,3281,5892,985,COIL20_old/17/COIL20-0.013442367165958313-101.0.tree,OLD
1287,483,507,2886,5163,961,COIL20_old/17/COIL20-0.02060830259333718-58.0.tree,OLD
1346,497,527,2982,5352,966,COIL20_old/17/COIL20-0.019134098572920144-65.0.tree,OLD
1497,542,572,3284,5895,985,COIL20_old/17/COIL20-0.013062798084803762-104.0.tree,OLD
1480,536,561,3257,5834,987,COIL20_old/17/COIL20-0.01108276976674999-116.0.tree,OLD
1480,536,561,3256,5833,987,COIL20_old/17/COIL20-0.011266988505105102-115.0.tree,OLD
811,257,312,1659,3039,741,COIL20_old/17/COIL20-0.02993112610850346-8.0.tree,OLD
616,248,262,1381,2507,651,COIL20_old/17/COIL20-0.08149238020716876-2.0.tree,OLD
823,278,332,1749,3182,763,COIL20_old/17/COIL20-0.02863322294880377-10.0.tree,OLD
422,150,146,874,1592,518,COIL20_old/17/COIL20-0.022458058536403314-25.0.tree,OLD
1289,484,506,2887,5166,963,COIL20_old/17/COIL20-0.021673594809597796-55.0.tree,OLD
824,262,324,1715,3125,762,COIL20_old/17/COIL20-0.03213574269692304-6.0.tree,OLD
1339,498,524,2984,5345,966,COIL20_old/17/COIL20-0.01885597147701007-68.0.tree,OLD
1322,493,520,2950,5285,961,COIL20_old/17/COIL20-0.019984501918920705-62.0.tree,OLD
1434,526,555,3171,5686,974,COIL20_old/17/COIL20-0.01757353146657714-76.0.tree,OLD
609,218,233,1303,2363,621,COIL20_old/17/COIL20-0.14875289934048758-1.0.tree,OLD
1504,541,572,3295,5912,986,COIL20_old/17/COIL20-0.012060883821446877-111.0.tree,OLD
1444,528,564,3201,5737,976,COIL20_old/17/COIL20-0.016949940383039264-78.0.tree,OLD
1507,540,569,3294,5910,987,COIL20_old/17/COIL20-0.01165902824353554-114.0.tree,OLD
817,257,319,1685,3078,750,COIL20_old/17/COIL20-0.02960582942097012-9.0.tree,OLD
811,257,312,1664,3044,743,COIL20_old/17/COIL20-0.03078386988598225-7.0.tree,OLD
1497,542,572,3280,5891,985,COIL20_old/17/COIL20-0.013591234909456795-100.0.tree,OLD
1466,532,567,3227,5792,979,COIL20_old/17/COIL20-0.015550863048661656-86.0.tree,OLD
1466,531,567,3224,5788,978,COIL20_old/17/COIL20-0.01594488225650187-84.0.tree,OLD
1322,493,520,2951,5286,961,COIL20_old/17/COIL20-0.019728905842462507-63.0.tree,OLD
1466,532,567,3226,5791,979,COIL20_old/17/COIL20-0.01582035034279755-85.0.tree,OLD
1466,532,567,3228,5793,979,COIL20_old/17/COIL20-0.01549557763246201-87.0.tree,OLD
710,230,297,1541,2778,737,COIL20_old/17/COIL20-0.05027533255086075-3.0.tree,OLD
409,144,147,859,1559,510,COIL20_old/17/COIL20-0.023878653867650146-21.0.tree,OLD
430,145,149,895,1619,512,COIL20_old/17/COIL20-0.025702059579700343-16.0.tree,OLD
1480,536,561,3258,5835,987,COIL20_old/17/COIL20-0.010964362564274743-117.0.tree,OLD
1467,532,567,3231,5797,979,COIL20_old/17/COIL20-0.015297665623370371-88.0.tree,OLD
828,278,333,1752,3191,766,COIL20_old/17/COIL20-0.027552316212087424-11.0.tree,OLD
1340,495,523,2985,5343,965,COIL20_old/17/COIL20-0.018127340431477845-73.0.tree,OLD
1489,541,569,3259,5858,983,COIL20_old/17/COIL20-0.01447698925031693-94.0.tree,OLD
1504,541,572,3297,5914,986,COIL20_old/17/COIL20-0.011875943158954239-113.0.tree,OLD
1339,498,524,2985,5346,966,COIL20_old/17/COIL20-0.018766045346151172-69.0.tree,OLD
606,227,240,1333,2406,682,COIL20_old/17/COIL20-0.0256163718421637-17.0.tree,OLD
170,72,63,404,709,293,COIL20_old/1/COIL20-0.0182855699008862-49.0.tree,OLD
198,79,76,489,842,333,COIL20_old/1/COIL20-0.01385267624264136-62.0.tree,OLD
252,90,81,576,999,374,COIL20_old/1/COIL20-0.011387689563305436-79.0.tree,OLD
252,90,81,575,998,373,COIL20_old/1/COIL20-0.011603242138013614-78.0.tree,OLD
190,79,73,473,815,323,COIL20_old/1/COIL20-0.016668518052760872-55.0.tree,OLD
607,193,204,1189,2193,668,COIL20_old/1/COIL20-0.037460585270883695-6.0.tree,OLD
255,84,84,567,990,367,COIL20_old/1/COIL20-0.011912167449139033-76.0.tree,OLD
170,72,63,405,710,294,COIL20_old/1/COIL20-0.01791158990982944-50.0.tree,OLD
913,310,347,1983,3553,830,COIL20_old/1/COIL20-0.034190303860197835-7.0.tree,OLD
842,320,300,1801,3263,818,COIL20_old/1/COIL20-0.061748546836574436-3.0.tree,OLD
185,78,73,462,798,321,COIL20_old/1/COIL20-0.016782721793724642-54.0.tree,OLD
245,83,81,555,964,360,COIL20_old/1/COIL20-0.01181324055443811-77.0.tree,OLD
443,129,173,957,1702,566,COIL20_old/1/COIL20-0.027246313529322996-18.0.tree,OLD
822,294,300,1740,3156,804,COIL20_old/1/COIL20-0.030522160742231186-11.0.tree,OLD
193,79,72,475,819,326,COIL20_old/1/COIL20-0.01509913648558009-57.0.tree,OLD
199,79,81,507,866,348,COIL20_old/1/COIL20-0.01326881427453569-64.0.tree,OLD
146,65,56,354,621,268,COIL20_old/1/COIL20-0.020506627729339533-43.0.tree,OLD
199,79,81,508,867,349,COIL20_old/1/COIL20-0.012918925590581554-65.0.tree,OLD
146,66,56,357,625,270,COIL20_old/1/COIL20-0.01989785937849259-45.0.tree,OLD
222,90,85,557,954,367,COIL20_old/1/COIL20-0.012539170206423977-72.0.tree,OLD
721,259,311,1563,2854,779,COIL20_old/1/COIL20-0.08477932409270494-2.0.tree,OLD
195,79,74,483,831,329,COIL20_old/1/COIL20-0.014289335550339566-60.0.tree,OLD
204,80,81,514,879,353,COIL20_old/1/COIL20-0.012748633001714027-67.0.tree,OLD
460,134,175,974,1743,568,COIL20_old/1/COIL20-0.02660326542588798-21.0.tree,OLD
797,289,291,1679,3056,796,COIL20_old/1/COIL20-0.03259443233474979-8.0.tree,OLD
693,219,267,1508,2687,753,COIL20_old/1/COIL20-0.025824472296743117-22.0.tree,OLD
354,109,119,734,1316,434,COIL20_old/1/COIL20-0.04088139950815972-5.0.tree,OLD
460,134,175,973,1742,568,COIL20_old/1/COIL20-0.02685259706386428-20.0.tree,OLD
146,66,56,359,627,271,COIL20_old/1/COIL20-0.019490205119606585-47.0.tree,OLD
119,37,43,265,464,176,COIL20_old/1/COIL20-0.02342244438855373-37.0.tree,OLD
235,90,86,569,980,369,COIL20_old/1/COIL20-0.012270870593934724-73.0.tree,OLD
443,163,167,950,1723,557,COIL20_old/1/COIL20-0.04507427667859071-4.0.tree,OLD
798,288,291,1682,3059,801,COIL20_old/1/COIL20-0.03164350687458062-9.0.tree,OLD
146,65,56,355,622,269,COIL20_old/1/COIL20-0.02016587953647847-44.0.tree,OLD
459,134,175,970,1738,567,COIL20_old/1/COIL20-0.02792776333929542-17.0.tree,OLD
691,219,267,1509,2686,753,COIL20_old/1/COIL20-0.02534307698040067-23.0.tree,OLD
193,79,72,476,820,327,COIL20_old/1/COIL20-0.014783050152768817-58.0.tree,OLD
145,65,55,349,614,264,COIL20_old/1/COIL20-0.020538392391385385-42.0.tree,OLD
147,66,56,360,629,270,COIL20_old/1/COIL20-0.018658501937550864-48.0.tree,OLD
691,219,267,1510,2687,754,COIL20_old/1/COIL20-0.024961644869215538-24.0.tree,OLD
815,284,297,1719,3115,804,COIL20_old/1/COIL20-0.029933093933974586-12.0.tree,OLD
111,35,41,260,447,184,COIL20_old/1/COIL20-0.02242753977569034-38.0.tree,OLD
698,221,268,1517,2704,755,COIL20_old/1/COIL20-0.02495073449959001-25.0.tree,OLD
245,85,92,514,936,315,COIL20_old/1/COIL20-0.1200249529584918-1.0.tree,OLD
198,79,76,488,841,332,COIL20_old/1/COIL20-0.014232548066175021-61.0.tree,OLD
243,89,85,570,987,368,COIL20_old/1/COIL20-0.012120722017288199-75.0.tree,OLD
206,81,81,517,885,355,COIL20_old/1/COIL20-0.01274022607869435-69.0.tree,OLD
252,90,81,577,1000,375,COIL20_old/1/COIL20-0.011154088885162061-80.0.tree,OLD
145,65,55,348,613,264,COIL20_old/1/COIL20-0.020806191314553635-41.0.tree,OLD
807,254,312,1755,3128,815,COIL20_old/1/COIL20-0.02449351199791372-27.0.tree,OLD
235,90,86,570,981,369,COIL20_old/1/COIL20-0.012251006036217427-74.0.tree,OLD
191,79,72,446,788,324,COIL20_old/1/COIL20-0.017741972669349793-51.0.tree,OLD
185,78,73,461,797,320,COIL20_old/1/COIL20-0.017119231593263284-53.0.tree,OLD
205,80,81,515,881,354,COIL20_old/1/COIL20-0.012746898054996625-68.0.tree,OLD
809,253,311,1758,3131,812,COIL20_old/1/COIL20-0.024714851609657806-26.0.tree,OLD
822,294,300,1739,3155,804,COIL20_old/1/COIL20-0.031027728873239457-10.0.tree,OLD
192,80,73,449,794,327,COIL20_old/1/COIL20-0.017613365377450563-52.0.tree,OLD
189,79,71,464,803,316,COIL20_old/1/COIL20-0.016185504229078496-56.0.tree,OLD
193,79,72,476,820,327,COIL20_old/1/COIL20-0.014463913108278437-59.0.tree,OLD
201,79,76,492,848,337,COIL20_old/1/COIL20-0.01379040446381996-63.0.tree,OLD
142,65,52,340,599,256,COIL20_old/1/COIL20-0.021392533441388084-40.0.tree,OLD
489,144,188,1025,1846,575,COIL20_old/1/COIL20-0.028103284056189115-15.0.tree,OLD
146,66,56,358,626,270,COIL20_old/1/COIL20-0.0197669815187424-46.0.tree,OLD
204,80,81,513,878,352,COIL20_old/1/COIL20-0.012892307548997672-66.0.tree,OLD
208,81,82,523,894,349,COIL20_old/1/COIL20-0.01259727345554823-71.0.tree,OLD
481,142,182,1003,1808,569,COIL20_old/1/COIL20-0.02898991169237608-14.0.tree,OLD
211,82,82,525,900,359,COIL20_old/1/COIL20-0.01271103472688001-70.0.tree,OLD
375,143,143,825,1486,535,COIL20_old/10/COIL20-0.01294390183694738-59.0.tree,OLD
912,329,397,2102,3740,858,COIL20_old/10/COIL20-0.033651166256799925-9.0.tree,OLD
375,143,143,824,1485,535,COIL20_old/10/COIL20-0.01330890435203902-58.0.tree,OLD
1299,496,534,2943,5272,950,COIL20_old/10/COIL20-0.028097520307027446-17.0.tree,OLD
415,154,167,957,1693,580,COIL20_old/10/COIL20-0.010936358894105158-75.0.tree,OLD
407,156,155,905,1623,571,COIL20_old/10/COIL20-0.012234390137118967-68.0.tree,OLD
256,101,90,544,991,398,COIL20_old/10/COIL20-0.019165898166778383-47.0.tree,OLD
436,197,190,1041,1864,640,COIL20_old/10/COIL20-0.044043275858858144-5.0.tree,OLD
1299,496,534,2942,5271,950,COIL20_old/10/COIL20-0.028405572322827033-16.0.tree,OLD
280,106,95,581,1062,408,COIL20_old/10/COIL20-0.015845629331544486-51.0.tree,OLD
1311,505,541,2976,5333,951,COIL20_old/10/COIL20-0.025852010209404364-20.0.tree,OLD
715,269,258,1472,2714,741,COIL20_old/10/COIL20-0.037977343226022975-7.0.tree,OLD
952,352,399,2169,3872,864,COIL20_old/10/COIL20-0.03208962105969149-10.0.tree,OLD
1248,467,502,2782,4999,947,COIL20_old/10/COIL20-0.02937279929577391-14.0.tree,OLD
51,30,16,149,246,111,COIL20_old/10/COIL20-0.024184970936731276-38.0.tree,OLD
348,137,132,779,1396,516,COIL20_old/10/COIL20-0.01542748388479026-53.0.tree,OLD
338,136,130,767,1371,509,COIL20_old/10/COIL20-0.014016622885460184-55.0.tree,OLD
415,154,167,958,1694,580,COIL20_old/10/COIL20-0.010673217546016633-76.0.tree,OLD
393,145,148,854,1540,552,COIL20_old/10/COIL20-0.01279674575229145-60.0.tree,OLD
695,247,242,1392,2576,725,COIL20_old/10/COIL20-0.03964704896042942-6.0.tree,OLD
1311,497,535,2957,5300,952,COIL20_old/10/COIL20-0.025191042085848103-25.0.tree,OLD
439,164,180,1014,1797,608,COIL20_old/10/COIL20-0.010469821242268751-78.0.tree,OLD
1290,497,534,2943,5264,949,COIL20_old/10/COIL20-0.02586255961696099-19.0.tree,OLD
952,352,399,2170,3873,864,COIL20_old/10/COIL20-0.031299486735226645-11.0.tree,OLD
280,103,94,577,1054,408,COIL20_old/10/COIL20-0.017355149415008098-48.0.tree,OLD
406,156,155,901,1618,569,COIL20_old/10/COIL20-0.012455776324614143-65.0.tree,OLD
415,154,167,959,1695,580,COIL20_old/10/COIL20-0.010601094995901506-77.0.tree,OLD
410,158,156,917,1641,576,COIL20_old/10/COIL20-0.01178771704299858-70.0.tree,OLD
1408,536,586,3209,5739,972,COIL20_old/10/COIL20-0.025021611148372147-27.0.tree,OLD
1311,497,535,2958,5301,952,COIL20_old/10/COIL20-0.02502255430732575-26.0.tree,OLD
171,68,63,408,710,326,COIL20_old/10/COIL20-0.020174530982189298-46.0.tree,OLD
1300,495,533,2943,5271,951,COIL20_old/10/COIL20-0.0257557963521865-22.0.tree,OLD
336,136,130,765,1367,510,COIL20_old/10/COIL20-0.014413261979282832-54.0.tree,OLD
284,103,93,574,1054,403,COIL20_old/10/COIL20-0.0170266157127954-49.0.tree,OLD
1300,495,533,2944,5272,951,COIL20_old/10/COIL20-0.02535770176615232-23.0.tree,OLD
401,151,155,890,1597,565,COIL20_old/10/COIL20-0.012736278783813837-62.0.tree,OLD
383,118,190,917,1608,353,COIL20_old/10/COIL20-0.13432653793129135-1.0.tree,OLD
281,106,95,582,1064,409,COIL20_old/10/COIL20-0.01581988458528899-52.0.tree,OLD
962,354,403,2190,3909,869,COIL20_old/10/COIL20-0.03050610375214302-12.0.tree,OLD
706,254,307,1580,2847,784,COIL20_old/10/COIL20-0.05756789580073113-3.0.tree,OLD
403,151,155,892,1601,565,COIL20_old/10/COIL20-0.01270620249273452-63.0.tree,OLD
404,152,157,913,1626,575,COIL20_old/10/COIL20-0.011489539086370015-71.0.tree,OLD
975,334,402,2172,3883,869,COIL20_old/10/COIL20-0.03647381977047509-8.0.tree,OLD
1408,536,586,3210,5740,973,COIL20_old/10/COIL20-0.02479666191593971-28.0.tree,OLD
395,146,148,859,1548,556,COIL20_old/10/COIL20-0.012782074390789266-61.0.tree,OLD
412,153,159,927,1651,578,COIL20_old/10/COIL20-0.011310012854906903-72.0.tree,OLD
1290,497,534,2942,5263,949,COIL20_old/10/COIL20-0.0264693717862729-18.0.tree,OLD
413,153,160,932,1658,580,COIL20_old/10/COIL20-0.011295353137342035-73.0.tree,OLD
155,64,56,360,635,283,COIL20_old/10/COIL20-0.02265896303748438-41.0.tree,OLD
104,45,31,258,438,192,COIL20_old/10/COIL20-0.02296986781801824-39.0.tree,OLD
171,68,63,407,709,325,COIL20_old/10/COIL20-0.020253278932856666-45.0.tree,OLD
403,151,155,893,1602,566,COIL20_old/10/COIL20-0.012585920616290436-64.0.tree,OLD
406,156,155,902,1619,569,COIL20_old/10/COIL20-0.012384003092631157-66.0.tree,OLD
1300,495,533,2945,5273,952,COIL20_old/10/COIL20-0.025216099839779238-24.0.tree,OLD
379,134,180,858,1551,437,COIL20_old/10/COIL20-0.08450538881436837-2.0.tree,OLD
406,156,155,903,1620,569,COIL20_old/10/COIL20-0.012279475463894685-67.0.tree,OLD
180,75,65,422,742,328,COIL20_old/10/COIL20-0.021120857086966538-44.0.tree,OLD
280,106,95,580,1061,407,COIL20_old/10/COIL20-0.01598632303077796-50.0.tree,OLD
405,156,155,905,1621,573,COIL20_old/10/COIL20-0.011792584208957235-69.0.tree,OLD
157,64,56,360,637,282,COIL20_old/10/COIL20-0.02234326095461686-42.0.tree,OLD
455,184,223,1136,1998,597,COIL20_old/10/COIL20-0.047632624450406114-4.0.tree,OLD
414,154,162,942,1672,585,COIL20_old/10/COIL20-0.011248463000223308-74.0.tree,OLD
157,64,56,361,638,283,COIL20_old/10/COIL20-0.02222462087338878-43.0.tree,OLD
361,139,137,794,1431,519,COIL20_old/10/COIL20-0.01333191277293444-57.0.tree,OLD
361,139,137,793,1430,518,COIL20_old/10/COIL20-0.014002510432968351-56.0.tree,OLD
526,163,175,1081,1945,619,COIL20_old/19/COIL20-0.011267570701989915-94.0.tree,OLD
736,309,285,1638,2968,783,COIL20_old/19/COIL20-0.027454448915715968-22.0.tree,OLD
517,164,180,1077,1938,620,COIL20_old/19/COIL20-0.013577844381101212-78.0.tree,OLD
511,162,179,1067,1919,620,COIL20_old/19/COIL20-0.013704053021834195-77.0.tree,OLD
505,155,175,1051,1886,608,COIL20_old/19/COIL20-0.012528760526119731-84.0.tree,OLD
496,161,174,1043,1874,596,COIL20_old/19/COIL20-0.013236711938296175-79.0.tree,OLD
501,163,177,1059,1900,620,COIL20_old/19/COIL20-0.013746844492883048-76.0.tree,OLD
338,105,122,728,1293,487,COIL20_old/19/COIL20-0.01827758215962344-62.0.tree,OLD
482,216,220,1100,2018,557,COIL20_old/19/COIL20-0.08708868954467541-2.0.tree,OLD
755,314,288,1631,2988,766,COIL20_old/19/COIL20-0.030510726395409582-10.0.tree,OLD
469,158,168,1015,1810,594,COIL20_old/19/COIL20-0.01532230419554359-70.0.tree,OLD
533,158,179,1088,1958,625,COIL20_old/19/COIL20-0.011891324800655911-89.0.tree,OLD
501,164,177,1059,1901,620,COIL20_old/19/COIL20-0.013949646955808637-75.0.tree,OLD
525,163,175,1079,1942,619,COIL20_old/19/COIL20-0.011432134473508937-93.0.tree,OLD
357,138,137,819,1451,505,COIL20_old/19/COIL20-0.020719083016617568-56.0.tree,OLD
494,166,227,1118,2005,544,COIL20_old/19/COIL20-0.05435109499590163-3.0.tree,OLD
476,156,170,1018,1820,599,COIL20_old/19/COIL20-0.01461618088158595-72.0.tree,OLD
522,160,175,1071,1928,617,COIL20_old/19/COIL20-0.011575634361726317-91.0.tree,OLD
377,177,180,892,1626,461,COIL20_old/19/COIL20-0.13862377971532952-1.0.tree,OLD
48,13,14,107,182,79,COIL20_old/19/COIL20-0.023219094660555994-30.0.tree,OLD
45,13,14,108,180,84,COIL20_old/19/COIL20-0.021745647496088594-33.0.tree,OLD
346,111,126,698,1281,437,COIL20_old/19/COIL20-0.04485655833147045-5.0.tree,OLD
590,233,232,1269,2324,637,COIL20_old/19/COIL20-0.028891159456739757-15.0.tree,OLD
362,142,138,835,1477,517,COIL20_old/19/COIL20-0.01945228081451622-59.0.tree,OLD
362,142,138,836,1478,517,COIL20_old/19/COIL20-0.019379366476637627-60.0.tree,OLD
772,318,289,1651,3030,767,COIL20_old/19/COIL20-0.029400313920560806-12.0.tree,OLD
335,105,122,725,1287,485,COIL20_old/19/COIL20-0.018261792980102276-63.0.tree,OLD
728,266,268,1527,2789,752,COIL20_old/19/COIL20-0.049045115601013545-4.0.tree,OLD
469,158,168,1014,1809,594,COIL20_old/19/COIL20-0.01563267335494445-69.0.tree,OLD
766,316,289,1649,3020,767,COIL20_old/19/COIL20-0.02990364641552984-11.0.tree,OLD
471,158,167,1015,1811,594,COIL20_old/19/COIL20-0.01621670998211494-68.0.tree,OLD
43,13,14,105,175,80,COIL20_old/19/COIL20-0.023806659400850028-29.0.tree,OLD
572,233,238,1269,2312,623,COIL20_old/19/COIL20-0.028426892372755475-16.0.tree,OLD
373,148,143,858,1522,525,COIL20_old/19/COIL20-0.01937929661301152-61.0.tree,OLD
496,161,174,1045,1876,597,COIL20_old/19/COIL20-0.012935751080557445-81.0.tree,OLD
44,13,14,106,177,82,COIL20_old/19/COIL20-0.022503015779864688-31.0.tree,OLD
629,260,253,1356,2498,676,COIL20_old/19/COIL20-0.03227338568447824-9.0.tree,OLD
435,126,148,895,1604,549,COIL20_old/19/COIL20-0.01262315792905555-83.0.tree,OLD
600,244,248,1332,2424,645,COIL20_old/19/COIL20-0.027559430658023132-18.0.tree,OLD
45,13,14,110,182,86,COIL20_old/19/COIL20-0.021392300562635413-35.0.tree,OLD
498,164,177,1057,1896,620,COIL20_old/19/COIL20-0.013956155916983293-74.0.tree,OLD
435,126,148,894,1603,548,COIL20_old/19/COIL20-0.01284184272300426-82.0.tree,OLD
736,309,285,1639,2969,784,COIL20_old/19/COIL20-0.027236532621655762-23.0.tree,OLD
510,157,173,1055,1895,608,COIL20_old/19/COIL20-0.012216260526120015-86.0.tree,OLD
476,157,170,1018,1821,599,COIL20_old/19/COIL20-0.014918224625531606-71.0.tree,OLD
43,13,14,104,174,79,COIL20_old/19/COIL20-0.024626287819509707-28.0.tree,OLD
572,233,238,1270,2313,623,COIL20_old/19/COIL20-0.027602059113944533-17.0.tree,OLD
45,13,14,109,181,85,COIL20_old/19/COIL20-0.021584704989194514-34.0.tree,OLD
496,161,174,1044,1875,596,COIL20_old/19/COIL20-0.012962450629704358-80.0.tree,OLD
772,318,289,1652,3031,767,COIL20_old/19/COIL20-0.02900076384231326-13.0.tree,OLD
496,163,177,1054,1890,618,COIL20_old/19/COIL20-0.013997340524629476-73.0.tree,OLD
357,138,137,820,1452,507,COIL20_old/19/COIL20-0.02011041946121178-57.0.tree,OLD
469,173,184,1002,1828,557,COIL20_old/19/COIL20-0.03620294684775305-7.0.tree,OLD
479,174,185,980,1818,535,COIL20_old/19/COIL20-0.03855010852149943-6.0.tree,OLD
471,173,192,1018,1854,571,COIL20_old/19/COIL20-0.03414902610105164-8.0.tree,OLD
493,143,166,1012,1814,590,COIL20_old/19/COIL20-0.012028711621580146-88.0.tree,OLD
417,147,159,940,1663,569,COIL20_old/19/COIL20-0.01807460503763314-66.0.tree,OLD
346,137,129,791,1403,490,COIL20_old/19/COIL20-0.02090863467844073-55.0.tree,OLD
493,143,166,1011,1813,590,COIL20_old/19/COIL20-0.012046026156942724-87.0.tree,OLD
510,157,173,1054,1894,607,COIL20_old/19/COIL20-0.012441081675235999-85.0.tree,OLD
363,143,139,839,1484,521,COIL20_old/19/COIL20-0.01997809775318521-58.0.tree,OLD
45,13,14,111,183,87,COIL20_old/19/COIL20-0.02113399144869238-36.0.tree,OLD
533,158,179,1089,1959,625,COIL20_old/19/COIL20-0.011854343654519317-90.0.tree,OLD
429,148,162,953,1692,577,COIL20_old/19/COIL20-0.017294659158655745-67.0.tree,OLD
525,163,175,1078,1941,618,COIL20_old/19/COIL20-0.011570615824577357-92.0.tree,OLD
413,154,161,886,1614,506,COIL20_old/26/COIL20-0.02750799938520082-17.0.tree,OLD
399,149,148,841,1537,489,COIL20_old/26/COIL20-0.02946874534242444-14.0.tree,OLD
435,159,164,929,1687,525,COIL20_old/26/COIL20-0.026787286217304418-18.0.tree,OLD
735,268,258,1585,2846,764,COIL20_old/26/COIL20-0.01268617491988927-73.0.tree,OLD
595,217,218,1298,2328,686,COIL20_old/26/COIL20-0.01303128958938854-68.0.tree,OLD
633,264,246,1382,2525,673,COIL20_old/26/COIL20-0.03467359713838536-9.0.tree,OLD
337,118,120,749,1324,476,COIL20_old/26/COIL20-0.01779655944928954-50.0.tree,OLD
351,124,125,790,1390,469,COIL20_old/26/COIL20-0.014892002477830346-60.0.tree,OLD
349,139,136,752,1376,438,COIL20_old/26/COIL20-0.033817150588717704-10.0.tree,OLD
329,116,122,743,1310,475,COIL20_old/26/COIL20-0.018706393453312542-47.0.tree,OLD
513,197,200,1110,2020,579,COIL20_old/26/COIL20-0.03998626015351486-7.0.tree,OLD
356,120,121,767,1364,477,COIL20_old/26/COIL20-0.01711251304121031-53.0.tree,OLD
762,275,263,1631,2931,778,COIL20_old/26/COIL20-0.01228812690960468-77.0.tree,OLD
330,116,122,742,1310,475,COIL20_old/26/COIL20-0.019361190289887698-46.0.tree,OLD
368,143,150,813,1474,463,COIL20_old/26/COIL20-0.032303427043744115-12.0.tree,OLD
412,157,161,888,1618,502,COIL20_old/26/COIL20-0.02818516422609746-16.0.tree,OLD
202,79,109,511,901,259,COIL20_old/26/COIL20-0.04363907984946802-6.0.tree,OLD
419,151,147,932,1649,537,COIL20_old/26/COIL20-0.014682749273417617-62.0.tree,OLD
591,215,218,1291,2315,683,COIL20_old/26/COIL20-0.013474201691632326-66.0.tree,OLD
307,116,156,752,1331,398,COIL20_old/26/COIL20-0.047444330333854645-5.0.tree,OLD
295,112,104,657,1168,440,COIL20_old/26/COIL20-0.023043853398167113-39.0.tree,OLD
350,124,125,788,1387,468,COIL20_old/26/COIL20-0.015342331768388284-58.0.tree,OLD
775,283,271,1681,3010,794,COIL20_old/26/COIL20-0.011472469073701252-85.0.tree,OLD
765,276,267,1653,2961,782,COIL20_old/26/COIL20-0.01199575927788843-81.0.tree,OLD
775,283,271,1680,3009,793,COIL20_old/26/COIL20-0.011776748453685315-84.0.tree,OLD
309,114,117,711,1251,455,COIL20_old/26/COIL20-0.019562595480288936-44.0.tree,OLD
732,268,258,1582,2840,761,COIL20_old/26/COIL20-0.012845429055817315-72.0.tree,OLD
331,116,121,746,1314,478,COIL20_old/26/COIL20-0.01802834367314954-49.0.tree,OLD
362,130,132,809,1433,485,COIL20_old/26/COIL20-0.016131255123333132-55.0.tree,OLD
365,125,126,792,1408,480,COIL20_old/26/COIL20-0.01580614473880243-56.0.tree,OLD
293,112,106,668,1179,446,COIL20_old/26/COIL20-0.0217271219912068-42.0.tree,OLD
597,218,218,1303,2336,686,COIL20_old/26/COIL20-0.012995705715777628-69.0.tree,OLD
369,127,127,806,1429,478,COIL20_old/26/COIL20-0.01571634669125871-57.0.tree,OLD
420,151,148,934,1653,538,COIL20_old/26/COIL20-0.014665225147178773-63.0.tree,OLD
644,233,230,1392,2499,711,COIL20_old/26/COIL20-0.012926936619718943-70.0.tree,OLD
293,112,106,667,1178,445,COIL20_old/26/COIL20-0.021851153215590113-41.0.tree,OLD
331,116,121,745,1313,477,COIL20_old/26/COIL20-0.01865670877114517-48.0.tree,OLD
761,275,263,1632,2931,778,COIL20_old/26/COIL20-0.012246395036887903-78.0.tree,OLD
756,271,262,1629,2918,777,COIL20_old/26/COIL20-0.01208042234890827-79.0.tree,OLD
368,143,150,812,1473,463,COIL20_old/26/COIL20-0.032870137491615714-11.0.tree,OLD
368,143,151,815,1477,464,COIL20_old/26/COIL20-0.03086462059393341-13.0.tree,OLD
366,126,125,793,1410,486,COIL20_old/26/COIL20-0.016914729115433846-54.0.tree,OLD
765,276,267,1654,2962,782,COIL20_old/26/COIL20-0.011777691612638808-82.0.tree,OLD
175,91,106,491,863,227,COIL20_old/26/COIL20-0.06340207914151574-3.0.tree,OLD
644,233,230,1393,2500,711,COIL20_old/26/COIL20-0.012853929130338004-71.0.tree,OLD
735,268,258,1586,2847,764,COIL20_old/26/COIL20-0.012585105540651231-74.0.tree,OLD
337,118,120,750,1325,476,COIL20_old/26/COIL20-0.017453447537075062-51.0.tree,OLD
434,169,171,933,1707,502,COIL20_old/26/COIL20-0.03593881576496044-8.0.tree,OLD
764,276,267,1651,2958,782,COIL20_old/26/COIL20-0.012057111185632075-80.0.tree,OLD
788,280,274,1697,3039,794,COIL20_old/26/COIL20-0.011211120892018311-87.0.tree,OLD
765,276,267,1655,2963,782,COIL20_old/26/COIL20-0.011776783385498368-83.0.tree,OLD
413,154,160,887,1614,506,COIL20_old/26/COIL20-0.026435324912437608-19.0.tree,OLD
788,280,274,1698,3040,795,COIL20_old/26/COIL20-0.010874937122736739-88.0.tree,OLD
754,271,262,1614,2901,773,COIL20_old/26/COIL20-0.012362275504880726-75.0.tree,OLD
350,124,125,789,1388,469,COIL20_old/26/COIL20-0.01503652703256575-59.0.tree,OLD
419,151,147,931,1648,536,COIL20_old/26/COIL20-0.014820729935166088-61.0.tree,OLD
493,187,234,1130,2044,542,COIL20_old/26/COIL20-0.0524508742268423-4.0.tree,OLD
353,120,121,764,1358,475,COIL20_old/26/COIL20-0.017140761234070656-52.0.tree,OLD
293,112,106,666,1177,445,COIL20_old/26/COIL20-0.022166214881884083-40.0.tree,OLD
309,114,117,710,1250,455,COIL20_old/26/COIL20-0.02066146881287856-43.0.tree,OLD
330,116,122,741,1309,474,COIL20_old/26/COIL20-0.019545397384305663-45.0.tree,OLD
227,111,126,638,1102,346,COIL20_old/26/COIL20-0.14000457606751704-1.0.tree,OLD
775,283,271,1682,3011,795,COIL20_old/26/COIL20-0.011426522095536351-86.0.tree,OLD
413,154,160,888,1615,507,COIL20_old/26/COIL20-0.02576299230568535-20.0.tree,OLD
760,274,263,1627,2924,777,COIL20_old/26/COIL20-0.012336356099559909-76.0.tree,OLD
171,86,109,509,875,268,COIL20_old/26/COIL20-0.09408131660332403-2.0.tree,OLD
161,84,77,430,752,282,COIL20_old/26/COIL20-0.023881692935390275-27.0.tree,OLD
597,218,218,1300,2333,691,COIL20_old/26/COIL20-0.01433241811982966-65.0.tree,OLD
433,168,165,923,1689,518,COIL20_old/26/COIL20-0.02494824269692325-21.0.tree,OLD
597,218,218,1299,2332,691,COIL20_old/26/COIL20-0.014337681179670048-64.0.tree,OLD
591,215,218,1292,2316,684,COIL20_old/26/COIL20-0.013141965217229046-67.0.tree,OLD
322,121,122,734,1299,501,COIL20_old/8/COIL20-0.008963491597733908-93.0.tree,OLD
76,28,37,205,346,158,COIL20_old/8/COIL20-0.019507915548847343-44.0.tree,OLD
76,28,37,203,344,156,COIL20_old/8/COIL20-0.020465687644385222-42.0.tree,OLD
83,34,33,203,353,156,COIL20_old/8/COIL20-0.02416674817423131-36.0.tree,OLD
217,85,95,513,910,378,COIL20_old/8/COIL20-0.013463233102317451-65.0.tree,OLD
210,80,89,498,877,371,COIL20_old/8/COIL20-0.01088686051494192-78.0.tree,OLD
749,291,281,1664,2985,823,COIL20_old/8/COIL20-0.007766564665773246-109.0.tree,OLD
301,112,124,673,1210,370,COIL20_old/8/COIL20-0.08554151296668899-2.0.tree,OLD
219,83,99,508,909,371,COIL20_old/8/COIL20-0.016397575266413222-50.0.tree,OLD
219,84,99,512,914,374,COIL20_old/8/COIL20-0.015505637994634724-53.0.tree,OLD
76,28,37,206,347,159,COIL20_old/8/COIL20-0.019196731313808058-45.0.tree,OLD
399,164,192,935,1690,460,COIL20_old/8/COIL20-0.04178931226246374-8.0.tree,OLD
74,28,36,198,336,152,COIL20_old/8/COIL20-0.020539580073029806-41.0.tree,OLD
76,28,37,204,345,157,COIL20_old/8/COIL20-0.019615843207393013-43.0.tree,OLD
217,85,95,512,909,377,COIL20_old/8/COIL20-0.013652388870257937-64.0.tree,OLD
590,228,230,1339,2387,753,COIL20_old/8/COIL20-0.008039510209404521-103.0.tree,OLD
169,86,77,424,756,317,COIL20_old/8/COIL20-0.02688003018108681-23.0.tree,OLD
313,116,122,722,1273,493,COIL20_old/8/COIL20-0.009206232766972133-91.0.tree,OLD
323,125,123,744,1315,502,COIL20_old/8/COIL20-0.008861187961099581-96.0.tree,OLD
79,32,33,197,341,159,COIL20_old/8/COIL20-0.023815683452566905-37.0.tree,OLD
321,123,122,734,1300,502,COIL20_old/8/COIL20-0.008908776734480761-94.0.tree,OLD
210,80,89,500,879,373,COIL20_old/8/COIL20-0.01033319127729404-80.0.tree,OLD
222,84,99,519,924,378,COIL20_old/8/COIL20-0.015071761588046129-59.0.tree,OLD
253,116,117,605,1091,354,COIL20_old/8/COIL20-0.06531279109844196-3.0.tree,OLD
205,81,90,488,864,367,COIL20_old/8/COIL20-0.012048459739921358-70.0.tree,OLD
219,83,99,513,914,375,COIL20_old/8/COIL20-0.015416131045532078-55.0.tree,OLD
217,85,95,509,906,376,COIL20_old/8/COIL20-0.014489029081898086-61.0.tree,OLD
89,36,32,215,372,169,COIL20_old/8/COIL20-0.026205368786794747-27.0.tree,OLD
590,228,230,1344,2392,754,COIL20_old/8/COIL20-0.007937975072659087-106.0.tree,OLD
217,85,95,508,905,375,COIL20_old/8/COIL20-0.014514785472090674-60.0.tree,OLD
219,83,99,509,910,372,COIL20_old/8/COIL20-0.016377536049631103-51.0.tree,OLD
219,83,99,510,911,372,COIL20_old/8/COIL20-0.015898958566212207-52.0.tree,OLD
590,228,230,1338,2386,752,COIL20_old/8/COIL20-0.008083128400029449-102.0.tree,OLD
402,158,193,976,1729,547,COIL20_old/8/COIL20-0.02880373677248732-19.0.tree,OLD
749,291,281,1666,2987,824,COIL20_old/8/COIL20-0.007451863961547567-113.0.tree,OLD
309,115,123,711,1258,489,COIL20_old/8/COIL20-0.01003247494224574-84.0.tree,OLD
217,85,95,510,907,376,COIL20_old/8/COIL20-0.014220496590655163-62.0.tree,OLD
202,81,89,479,851,360,COIL20_old/8/COIL20-0.012271906904389618-69.0.tree,OLD
73,25,34,187,319,148,COIL20_old/8/COIL20-0.022063166033236714-38.0.tree,OLD
259,101,109,614,1083,441,COIL20_old/8/COIL20-0.010333039906103958-81.0.tree,OLD
217,85,95,511,908,376,COIL20_old/8/COIL20-0.014078533702213902-63.0.tree,OLD
584,225,229,1329,2367,750,COIL20_old/8/COIL20-0.00831473796482568-100.0.tree,OLD
674,264,257,1514,2709,796,COIL20_old/8/COIL20-0.00791486185632323-108.0.tree,OLD
171,66,82,418,737,321,COIL20_old/8/COIL20-0.01828161096206876-48.0.tree,OLD
210,83,91,500,884,376,COIL20_old/8/COIL20-0.011016725352112955-76.0.tree,OLD
309,115,123,713,1260,490,COIL20_old/8/COIL20-0.00985334460466497-86.0.tree,OLD
168,86,77,422,753,316,COIL20_old/8/COIL20-0.028152700927787933-22.0.tree,OLD
538,241,251,1257,2287,641,COIL20_old/8/COIL20-0.05833077166703926-4.0.tree,OLD
162,54,52,342,610,247,COIL20_old/8/COIL20-0.026565317832923374-26.0.tree,OLD
590,228,230,1342,2390,754,COIL20_old/8/COIL20-0.0080241984313284-104.0.tree,OLD
749,291,281,1665,2986,824,COIL20_old/8/COIL20-0.007462494876666559-112.0.tree,OLD
217,85,95,514,911,379,COIL20_old/8/COIL20-0.013406946307474021-66.0.tree,OLD
724,288,329,1669,3010,727,COIL20_old/8/COIL20-0.036240545122588286-11.0.tree,OLD
73,25,34,188,320,148,COIL20_old/8/COIL20-0.021522666089127285-39.0.tree,OLD
73,25,34,189,321,149,COIL20_old/8/COIL20-0.020634361725910655-40.0.tree,OLD
565,215,262,1262,2304,602,COIL20_old/8/COIL20-0.046756488002087426-6.0.tree,OLD
169,66,81,410,726,316,COIL20_old/8/COIL20-0.018473631138684554-47.0.tree,OLD
408,157,187,959,1711,541,COIL20_old/8/COIL20-0.03138257787465515-16.0.tree,OLD
77,32,26,180,315,137,COIL20_old/8/COIL20-0.024803869513376098-28.0.tree,OLD
749,291,281,1663,2984,823,COIL20_old/8/COIL20-0.007749471365228078-110.0.tree,OLD
306,115,120,709,1250,488,COIL20_old/8/COIL20-0.009211891720695087-90.0.tree,OLD
263,102,110,623,1098,444,COIL20_old/8/COIL20-0.010136536813473096-82.0.tree,OLD
291,111,117,683,1202,479,COIL20_old/8/COIL20-0.00939890500409879-89.0.tree,OLD
809,312,299,1796,3216,852,COIL20_old/8/COIL20-0.007161708677994094-117.0.tree,OLD
749,291,281,1667,2988,825,COIL20_old/8/COIL20-0.007241166908859953-114.0.tree,OLD
586,227,229,1332,2374,751,COIL20_old/8/COIL20-0.0082895870593927-101.0.tree,OLD
205,81,90,491,867,369,COIL20_old/8/COIL20-0.011653334357999534-73.0.tree,OLD
174,87,78,430,769,323,COIL20_old/8/COIL20-0.028384624878902698-21.0.tree,OLD
770,293,286,1704,3053,832,COIL20_old/8/COIL20-0.007217180397198153-115.0.tree,OLD
309,115,123,712,1259,490,COIL20_old/8/COIL20-0.009925560306280945-85.0.tree,OLD
219,83,99,514,915,375,COIL20_old/8/COIL20-0.015345044805872787-56.0.tree,OLD
208,83,90,497,878,373,COIL20_old/8/COIL20-0.011406587674193502-75.0.tree,OLD
654,254,294,1467,2669,640,COIL20_old/8/COIL20-0.04388545392726734-7.0.tree,OLD
724,288,329,1670,3011,727,COIL20_old/8/COIL20-0.03503613113868437-12.0.tree,OLD
583,227,229,1328,2367,751,COIL20_old/8/COIL20-0.00844308909009589-99.0.tree,OLD
309,115,123,714,1261,490,COIL20_old/8/COIL20-0.009635672833295528-87.0.tree,OLD
404,153,185,950,1692,535,COIL20_old/8/COIL20-0.03184897579923984-15.0.tree,OLD
405,158,188,964,1715,538,COIL20_old/8/COIL20-0.030296151911468894-17.0.tree,OLD
219,83,99,512,913,374,COIL20_old/8/COIL20-0.015419961901036228-54.0.tree,OLD
749,291,281,1664,2985,824,COIL20_old/8/COIL20-0.0075575676279896475-111.0.tree,OLD
223,97,106,542,968,284,COIL20_old/8/COIL20-0.12987468794247037-1.0.tree,OLD
222,84,99,518,923,377,COIL20_old/8/COIL20-0.01514159028243467-58.0.tree,OLD
255,128,124,632,1139,350,COIL20_old/8/COIL20-0.05366492939116252-5.0.tree,OLD
320,121,122,732,1295,498,COIL20_old/8/COIL20-0.009073375437811948-92.0.tree,OLD
219,83,99,515,916,376,COIL20_old/8/COIL20-0.015178524852820063-57.0.tree,OLD
809,312,299,1795,3215,851,COIL20_old/8/COIL20-0.007202648762947184-116.0.tree,OLD
590,228,230,1343,2391,754,COIL20_old/8/COIL20-0.007997557101870612-105.0.tree,OLD
294,111,117,684,1206,480,COIL20_old/8/COIL20-0.009546468626574323-88.0.tree,OLD
205,81,90,490,866,369,COIL20_old/8/COIL20-0.011832348256203717-72.0.tree,OLD
207,82,91,498,878,371,COIL20_old/8/COIL20-0.012594339183247483-68.0.tree,OLD
408,157,187,957,1709,540,COIL20_old/8/COIL20-0.03361320701989695-14.0.tree,OLD
210,80,89,499,878,372,COIL20_old/8/COIL20-0.010460878698115517-79.0.tree,OLD
171,66,83,420,740,323,COIL20_old/8/COIL20-0.01803952185334251-49.0.tree,OLD
325,125,123,744,1317,502,COIL20_old/8/COIL20-0.008905260265294923-95.0.tree,OLD
315,122,120,732,1289,493,COIL20_old/8/COIL20-0.008603973377299845-98.0.tree,OLD
207,82,91,497,877,370,COIL20_old/8/COIL20-0.012813536310455786-67.0.tree,OLD
724,288,329,1668,3009,726,COIL20_old/8/COIL20-0.038392763991355994-10.0.tree,OLD
162,63,81,401,707,310,COIL20_old/8/COIL20-0.018568133337060144-46.0.tree,OLD
323,125,123,745,1316,503,COIL20_old/8/COIL20-0.008799603174602488-97.0.tree,OLD
405,158,188,965,1716,539,COIL20_old/8/COIL20-0.029347892913033802-18.0.tree,OLD
309,115,123,710,1257,488,COIL20_old/8/COIL20-0.010066288937327472-83.0.tree,OLD
624,243,283,1401,2551,647,COIL20_old/8/COIL20-0.03985367063492118-9.0.tree,OLD
208,83,90,496,877,373,COIL20_old/8/COIL20-0.011653206274684469-74.0.tree,OLD
674,264,257,1513,2708,797,COIL20_old/8/COIL20-0.007930383225278115-107.0.tree,OLD
105,52,38,288,483,224,COIL20_old/21/COIL20-0.02153209767866443-47.0.tree,OLD
385,147,129,829,1490,546,COIL20_old/21/COIL20-0.011725806226246083-75.0.tree,OLD
302,107,117,628,1154,388,COIL20_old/21/COIL20-0.04228998993963784-6.0.tree,OLD
316,129,158,788,1391,364,COIL20_old/21/COIL20-0.05935650942693166-3.0.tree,OLD
191,88,70,488,837,371,COIL20_old/21/COIL20-0.018250731239287665-54.0.tree,OLD
1060,431,421,2370,4282,874,COIL20_old/21/COIL20-0.028027412158133536-17.0.tree,OLD
211,91,76,523,901,397,COIL20_old/21/COIL20-0.0163669400663235-57.0.tree,OLD
280,107,95,642,1124,457,COIL20_old/21/COIL20-0.013899647887323785-67.0.tree,OLD
104,51,38,288,481,226,COIL20_old/21/COIL20-0.021226898427602447-48.0.tree,OLD
312,112,100,680,1204,466,COIL20_old/21/COIL20-0.01286857720396406-70.0.tree,OLD
1056,413,419,2365,4253,875,COIL20_old/21/COIL20-0.026254436340264198-20.0.tree,OLD
567,244,227,1273,2311,655,COIL20_old/21/COIL20-0.054071349392652346-4.0.tree,OLD
1059,413,419,2253,4144,866,COIL20_old/21/COIL20-0.033269978668305944-9.0.tree,OLD
278,108,97,644,1127,463,COIL20_old/21/COIL20-0.014205685501900212-65.0.tree,OLD
105,52,38,286,481,222,COIL20_old/21/COIL20-0.021749757806096337-45.0.tree,OLD
242,107,90,588,1027,436,COIL20_old/21/COIL20-0.015468307530367986-59.0.tree,OLD
1060,410,415,2236,4121,867,COIL20_old/21/COIL20-0.03147217797525931-11.0.tree,OLD
390,153,136,864,1543,567,COIL20_old/21/COIL20-0.011837506520605334-74.0.tree,OLD
190,69,58,439,756,334,COIL20_old/21/COIL20-0.013606022710335286-68.0.tree,OLD
105,52,38,287,482,223,COIL20_old/21/COIL20-0.021588780367389537-46.0.tree,OLD
105,53,38,284,480,221,COIL20_old/21/COIL20-0.022424430844325438-42.0.tree,OLD
1166,443,440,2519,4568,905,COIL20_old/21/COIL20-0.024532868507340877-22.0.tree,OLD
530,215,172,1142,2059,637,COIL20_old/21/COIL20-0.010630996627916056-77.0.tree,OLD
90,43,30,253,416,202,COIL20_old/21/COIL20-0.01923092955883471-51.0.tree,OLD
100,52,38,277,467,214,COIL20_old/21/COIL20-0.023476914729116005-40.0.tree,OLD
105,53,38,285,481,224,COIL20_old/21/COIL20-0.022027675311125927-43.0.tree,OLD
1060,410,416,2238,4124,867,COIL20_old/21/COIL20-0.03083419498472284-12.0.tree,OLD
90,43,30,252,415,202,COIL20_old/21/COIL20-0.019829427956628898-50.0.tree,OLD
270,110,95,634,1109,457,COIL20_old/21/COIL20-0.014847965105447114-62.0.tree,OLD
394,135,181,876,1586,502,COIL20_old/21/COIL20-0.03731154286832139-7.0.tree,OLD
278,108,97,643,1126,463,COIL20_old/21/COIL20-0.014328936582457319-64.0.tree,OLD
897,374,367,2048,3686,853,COIL20_old/21/COIL20-0.02824033320292163-15.0.tree,OLD
180,83,68,468,799,356,COIL20_old/21/COIL20-0.018300870035024452-53.0.tree,OLD
522,193,282,1314,2311,686,COIL20_old/21/COIL20-0.14067965664356458-1.0.tree,OLD
1059,412,416,2245,4132,868,COIL20_old/21/COIL20-0.03240255188538649-10.0.tree,OLD
533,217,173,1149,2072,639,COIL20_old/21/COIL20-0.010164424044266374-79.0.tree,OLD
104,52,37,289,482,223,COIL20_old/21/COIL20-0.0208538499515612-49.0.tree,OLD
191,88,70,489,838,372,COIL20_old/21/COIL20-0.018120319137045038-55.0.tree,OLD
291,111,95,643,1140,456,COIL20_old/21/COIL20-0.013601970620015669-69.0.tree,OLD
931,381,393,2126,3831,858,COIL20_old/21/COIL20-0.029079756315671168-14.0.tree,OLD
530,215,172,1143,2060,638,COIL20_old/21/COIL20-0.010460180061852786-78.0.tree,OLD
242,107,90,590,1029,437,COIL20_old/21/COIL20-0.015232482860123353-61.0.tree,OLD
244,108,90,591,1033,438,COIL20_old/21/COIL20-0.01612339546538405-58.0.tree,OLD
493,202,167,1078,1940,619,COIL20_old/21/COIL20-0.010865424025634451-76.0.tree,OLD
542,224,172,1142,2080,636,COIL20_old/21/COIL20-0.010098367985691692-80.0.tree,OLD
1166,443,440,2518,4567,905,COIL20_old/21/COIL20-0.02515094036440857-21.0.tree,OLD
806,321,327,1743,3197,762,COIL20_old/21/COIL20-0.0345784195916235-8.0.tree,OLD
105,53,38,286,482,226,COIL20_old/21/COIL20-0.021844423019600157-44.0.tree,OLD
399,158,137,879,1573,574,COIL20_old/21/COIL20-0.011885269953051336-73.0.tree,OLD
303,108,118,631,1160,387,COIL20_old/21/COIL20-0.044098014009986086-5.0.tree,OLD
105,53,38,283,479,220,COIL20_old/21/COIL20-0.023292172013563595-41.0.tree,OLD
276,108,97,642,1123,463,COIL20_old/21/COIL20-0.014356055313361316-63.0.tree,OLD
166,79,65,436,746,343,COIL20_old/21/COIL20-0.01884198710783136-52.0.tree,OLD
191,88,70,490,839,373,COIL20_old/21/COIL20-0.017472997708473437-56.0.tree,OLD
314,114,100,685,1213,468,COIL20_old/21/COIL20-0.0123222436470668-72.0.tree,OLD
277,107,96,642,1122,461,COIL20_old/21/COIL20-0.014168331749758067-66.0.tree,OLD
101,51,39,278,469,214,COIL20_old/21/COIL20-0.023683303524852928-39.0.tree,OLD
314,114,100,684,1212,468,COIL20_old/21/COIL20-0.012326877934271674-71.0.tree,OLD
1168,448,456,2573,4645,903,COIL20_old/21/COIL20-0.027043615861837456-18.0.tree,OLD
564,240,256,1314,2374,613,COIL20_old/21/COIL20-0.07841118470079778-2.0.tree,OLD
242,107,90,589,1028,436,COIL20_old/21/COIL20-0.01530964723526429-60.0.tree,OLD
436,155,172,1014,1777,620,COIL20_old/30/COIL20-0.016534694276772177-54.0.tree,OLD
359,119,148,841,1467,545,COIL20_old/30/COIL20-0.02322896871972524-41.0.tree,OLD
457,174,180,1094,1905,642,COIL20_old/30/COIL20-0.010826451766152656-82.0.tree,OLD
433,155,170,1010,1768,620,COIL20_old/30/COIL20-0.015574348871004173-58.0.tree,OLD
450,170,177,1071,1868,637,COIL20_old/30/COIL20-0.012569304717192864-72.0.tree,OLD
418,148,159,949,1674,595,COIL20_old/30/COIL20-0.01864763814367737-49.0.tree,OLD
482,174,181,1105,1942,642,COIL20_old/30/COIL20-0.013865682521052414-67.0.tree,OLD
458,169,179,1080,1886,640,COIL20_old/30/COIL20-0.012903229562558627-70.0.tree,OLD
269,106,95,536,1006,360,COIL20_old/30/COIL20-0.03806289123630624-6.0.tree,OLD
487,176,183,1114,1960,646,COIL20_old/30/COIL20-0.013893383448840613-66.0.tree,OLD
359,119,148,839,1465,545,COIL20_old/30/COIL20-0.02367671305611435-39.0.tree,OLD
449,169,176,1069,1863,637,COIL20_old/30/COIL20-0.01251184188464094-73.0.tree,OLD
433,155,170,1011,1769,621,COIL20_old/30/COIL20-0.015251718645204748-59.0.tree,OLD
422,152,167,987,1728,611,COIL20_old/30/COIL20-0.016093377393994024-55.0.tree,OLD
461,176,180,1106,1923,648,COIL20_old/30/COIL20-0.010495950238468388-86.0.tree,OLD
460,169,155,942,1726,560,COIL20_old/30/COIL20-0.026965054214173667-20.0.tree,OLD
415,119,143,805,1482,469,COIL20_old/30/COIL20-0.02677814572620968-28.0.tree,OLD
425,148,148,884,1605,501,COIL20_old/30/COIL20-0.03325550525374493-9.0.tree,OLD
418,148,159,948,1673,595,COIL20_old/30/COIL20-0.019298522617184566-48.0.tree,OLD
433,155,170,1008,1766,619,COIL20_old/30/COIL20-0.015950809020790768-56.0.tree,OLD
461,176,180,1103,1920,647,COIL20_old/30/COIL20-0.010518865507862074-83.0.tree,OLD
454,171,178,1088,1891,642,COIL20_old/30/COIL20-0.011093063007675208-79.0.tree,OLD
451,167,155,925,1698,551,COIL20_old/30/COIL20-0.029391848777851892-14.0.tree,OLD
454,171,178,1087,1890,642,COIL20_old/30/COIL20-0.011428385125567486-78.0.tree,OLD
461,172,179,1103,1915,651,COIL20_old/30/COIL20-0.010140845070422955-88.0.tree,OLD
369,123,147,855,1494,552,COIL20_old/30/COIL20-0.021866825955734415-43.0.tree,OLD
373,124,148,863,1508,556,COIL20_old/30/COIL20-0.02099857245323783-44.0.tree,OLD
457,174,180,1093,1904,642,COIL20_old/30/COIL20-0.010832914151575723-81.0.tree,OLD
414,148,158,946,1666,595,COIL20_old/30/COIL20-0.018104553245398614-50.0.tree,OLD
454,171,178,1086,1889,642,COIL20_old/30/COIL20-0.011496735039869643-77.0.tree,OLD
425,154,167,992,1738,616,COIL20_old/30/COIL20-0.015176964565168594-60.0.tree,OLD
484,149,196,1034,1863,520,COIL20_old/30/COIL20-0.06869040632684975-2.0.tree,OLD
372,125,143,850,1490,552,COIL20_old/30/COIL20-0.019350163480884974-47.0.tree,OLD
449,169,176,1071,1865,638,COIL20_old/30/COIL20-0.011896541284745155-75.0.tree,OLD
465,171,181,1089,1906,642,COIL20_old/30/COIL20-0.013325857925330253-68.0.tree,OLD
281,115,104,564,1064,380,COIL20_old/30/COIL20-0.03681637277367916-7.0.tree,OLD
452,168,155,927,1702,551,COIL20_old/30/COIL20-0.02884515425888612-15.0.tree,OLD
294,101,105,624,1124,365,COIL20_old/30/COIL20-0.047407547134660666-4.0.tree,OLD
423,151,170,998,1742,617,COIL20_old/30/COIL20-0.014887251751247832-61.0.tree,OLD
577,197,197,1123,2094,626,COIL20_old/30/COIL20-0.03177702790819009-11.0.tree,OLD
398,148,142,843,1531,516,COIL20_old/30/COIL20-0.03491509240629004-8.0.tree,OLD
266,86,110,570,1032,265,COIL20_old/30/COIL20-0.15346941603323633-1.0.tree,OLD
460,169,155,938,1722,557,COIL20_old/30/COIL20-0.02847221057828525-16.0.tree,OLD
368,123,152,868,1511,557,COIL20_old/30/COIL20-0.021907463298308227-42.0.tree,OLD
427,156,146,850,1579,489,COIL20_old/30/COIL20-0.031021697313510843-13.0.tree,OLD
412,147,158,949,1666,604,COIL20_old/30/COIL20-0.017436377524405966-51.0.tree,OLD
359,119,147,839,1464,544,COIL20_old/30/COIL20-0.023330352485281813-40.0.tree,OLD
449,169,176,1070,1864,638,COIL20_old/30/COIL20-0.012290397477457804-74.0.tree,OLD
448,156,175,1042,1821,628,COIL20_old/30/COIL20-0.014545385740368344-63.0.tree,OLD
484,169,187,1125,1965,653,COIL20_old/30/COIL20-0.01422768090021681-65.0.tree,OLD
458,169,179,1081,1887,640,COIL20_old/30/COIL20-0.01262794358745084-71.0.tree,OLD
266,92,78,507,943,336,COIL20_old/30/COIL20-0.04127138991355522-5.0.tree,OLD
460,169,155,941,1725,560,COIL20_old/30/COIL20-0.027185345871525712-19.0.tree,OLD
658,262,258,1395,2573,680,COIL20_old/30/COIL20-0.061728076794098585-3.0.tree,OLD
428,148,150,891,1617,504,COIL20_old/30/COIL20-0.031942988952232076-10.0.tree,OLD
372,125,143,849,1489,551,COIL20_old/30/COIL20-0.019848698673521237-46.0.tree,OLD
371,122,144,850,1487,553,COIL20_old/30/COIL20-0.020146515668082288-45.0.tree,OLD
454,171,178,1089,1892,642,COIL20_old/30/COIL20-0.010908564814815003-80.0.tree,OLD
416,147,161,962,1686,605,COIL20_old/30/COIL20-0.01720942553468996-52.0.tree,OLD
461,176,180,1107,1924,649,COIL20_old/30/COIL20-0.01046099513749138-87.0.tree,OLD
433,155,170,1009,1767,619,COIL20_old/30/COIL20-0.015681147067591827-57.0.tree,OLD
337,119,139,793,1388,527,COIL20_old/30/COIL20-0.0239321228295703-38.0.tree,OLD
466,163,184,1093,1906,641,COIL20_old/30/COIL20-0.01422823980922655-64.0.tree,OLD
458,169,179,1079,1885,640,COIL20_old/30/COIL20-0.01297461854460058-69.0.tree,OLD
451,169,177,1074,1871,638,COIL20_old/30/COIL20-0.01178849718682412-76.0.tree,OLD
460,169,155,939,1723,558,COIL20_old/30/COIL20-0.02811873556151767-17.0.tree,OLD
347,121,143,813,1424,534,COIL20_old/30/COIL20-0.024624552872792305-37.0.tree,OLD
495,148,175,1003,1821,565,COIL20_old/30/COIL20-0.02550910788806976-29.0.tree,OLD
461,176,180,1104,1921,647,COIL20_old/30/COIL20-0.010506010600640159-84.0.tree,OLD
439,156,176,1032,1803,624,COIL20_old/30/COIL20-0.014604338996944688-62.0.tree,OLD
348,120,143,810,1421,534,COIL20_old/30/COIL20-0.025375109453015743-36.0.tree,OLD
461,176,180,1105,1922,647,COIL20_old/30/COIL20-0.010503483866159569-85.0.tree,OLD
460,169,155,940,1724,559,COIL20_old/30/COIL20-0.027908539198151838-18.0.tree,OLD
436,152,170,1002,1760,618,COIL20_old/30/COIL20-0.016790325285044205-53.0.tree,OLD
435,157,181,976,1749,627,COIL20_old/24/COIL20-0.013037565671808138-78.0.tree,OLD
86,35,44,210,375,133,COIL20_old/24/COIL20-0.08766830147551985-2.0.tree,OLD
502,195,218,1155,2070,623,COIL20_old/24/COIL20-0.04105392773306504-5.0.tree,OLD
75,22,27,168,292,145,COIL20_old/24/COIL20-0.02409740852522607-29.0.tree,OLD
123,34,49,276,482,187,COIL20_old/24/COIL20-0.020288967601908403-35.0.tree,OLD
294,125,165,775,1359,372,COIL20_old/24/COIL20-0.12610718710410618-1.0.tree,OLD
64,17,28,148,257,134,COIL20_old/24/COIL20-0.02673648371711712-25.0.tree,OLD
84,26,31,201,342,171,COIL20_old/24/COIL20-0.021960943904165697-32.0.tree,OLD
94,39,35,237,405,207,COIL20_old/24/COIL20-0.01780016906997589-57.0.tree,OLD
408,151,175,920,1654,604,COIL20_old/24/COIL20-0.01350453414934133-74.0.tree,OLD
441,159,181,985,1766,630,COIL20_old/24/COIL20-0.011943582793054686-83.0.tree,OLD
240,83,90,545,958,417,COIL20_old/24/COIL20-0.01407752067963397-70.0.tree,OLD
182,86,95,470,833,276,COIL20_old/24/COIL20-0.0636218933974213-3.0.tree,OLD
441,159,181,986,1767,630,COIL20_old/24/COIL20-0.011545790949399504-84.0.tree,OLD
411,137,169,960,1677,550,COIL20_old/24/COIL20-0.02806597687979745-19.0.tree,OLD
404,137,169,948,1658,546,COIL20_old/24/COIL20-0.0288266636858191-18.0.tree,OLD
446,160,181,994,1781,633,COIL20_old/24/COIL20-0.011346225501155438-86.0.tree,OLD
403,132,166,935,1636,536,COIL20_old/24/COIL20-0.029438284801401482-16.0.tree,OLD
94,39,35,235,403,206,COIL20_old/24/COIL20-0.017971963726804874-55.0.tree,OLD
64,17,28,147,256,133,COIL20_old/24/COIL20-0.027116693214844945-24.0.tree,OLD
581,232,241,1296,2350,672,COIL20_old/24/COIL20-0.037955732077650906-6.0.tree,OLD
439,159,181,983,1762,629,COIL20_old/24/COIL20-0.012626651110365983-81.0.tree,OLD
589,214,233,1310,2346,700,COIL20_old/24/COIL20-0.03485757135404999-9.0.tree,OLD
204,69,76,458,807,359,COIL20_old/24/COIL20-0.015096959069229865-65.0.tree,OLD
204,69,76,456,805,357,COIL20_old/24/COIL20-0.015674370295848727-63.0.tree,OLD
202,69,76,451,798,353,COIL20_old/24/COIL20-0.016231684085997622-59.0.tree,OLD
239,83,90,543,955,415,COIL20_old/24/COIL20-0.014702311088755471-69.0.tree,OLD
237,83,90,542,952,414,COIL20_old/24/COIL20-0.014724900327893642-68.0.tree,OLD
64,17,28,150,259,135,COIL20_old/24/COIL20-0.026486709609508663-27.0.tree,OLD
64,17,28,149,258,135,COIL20_old/24/COIL20-0.02673194258141398-26.0.tree,OLD
437,158,181,980,1756,628,COIL20_old/24/COIL20-0.012942003875102803-80.0.tree,OLD
574,209,222,1264,2269,684,COIL20_old/24/COIL20-0.03623731975184552-8.0.tree,OLD
383,129,153,864,1529,496,COIL20_old/24/COIL20-0.032725449921752414-11.0.tree,OLD
202,69,76,450,797,352,COIL20_old/24/COIL20-0.016594963298309118-58.0.tree,OLD
77,37,28,194,336,173,COIL20_old/24/COIL20-0.019885935986288517-51.0.tree,OLD
480,201,188,1081,1950,532,COIL20_old/24/COIL20-0.04660536133467502-4.0.tree,OLD
408,151,175,918,1652,604,COIL20_old/24/COIL20-0.013872121618600686-72.0.tree,OLD
84,26,31,200,341,170,COIL20_old/24/COIL20-0.02273264587525109-31.0.tree,OLD
94,39,35,234,402,205,COIL20_old/24/COIL20-0.018245875717267934-54.0.tree,OLD
425,157,179,958,1719,619,COIL20_old/24/COIL20-0.013170446288843674-77.0.tree,OLD
204,69,76,457,806,358,COIL20_old/24/COIL20-0.015198762016543466-64.0.tree,OLD
203,69,76,452,800,354,COIL20_old/24/COIL20-0.015824961342126576-60.0.tree,OLD
89,26,34,213,362,178,COIL20_old/24/COIL20-0.021957136336537453-33.0.tree,OLD
408,151,175,921,1655,604,COIL20_old/24/COIL20-0.013425553319918848-75.0.tree,OLD
370,129,152,865,1516,490,COIL20_old/24/COIL20-0.03074389624785767-14.0.tree,OLD
81,24,29,176,310,152,COIL20_old/24/COIL20-0.02479479888590913-28.0.tree,OLD
581,232,241,1297,2351,673,COIL20_old/24/COIL20-0.03690834823757333-7.0.tree,OLD
94,39,35,236,404,207,COIL20_old/24/COIL20-0.017835613216335033-56.0.tree,OLD
376,125,148,852,1501,484,COIL20_old/24/COIL20-0.0313937444109092-13.0.tree,OLD
403,137,169,945,1654,543,COIL20_old/24/COIL20-0.029070708976079218-17.0.tree,OLD
77,37,28,196,338,175,COIL20_old/24/COIL20-0.018549165362545805-53.0.tree,OLD
410,152,175,924,1661,604,COIL20_old/24/COIL20-0.013206996609284982-76.0.tree,OLD
66,18,30,153,267,135,COIL20_old/24/COIL20-0.027402912847454608-23.0.tree,OLD
93,26,34,216,369,181,COIL20_old/24/COIL20-0.021323950648333978-34.0.tree,OLD
77,37,28,195,337,174,COIL20_old/24/COIL20-0.019739629909084178-52.0.tree,OLD
408,151,175,919,1653,604,COIL20_old/24/COIL20-0.013634748304642896-73.0.tree,OLD
204,69,76,459,808,360,COIL20_old/24/COIL20-0.014964218179447097-66.0.tree,OLD
441,159,181,984,1765,629,COIL20_old/24/COIL20-0.012210648148147873-82.0.tree,OLD
86,26,31,199,342,171,COIL20_old/24/COIL20-0.023776257079513363-30.0.tree,OLD
240,83,90,546,959,418,COIL20_old/24/COIL20-0.01389686498621373-71.0.tree,OLD
370,129,152,863,1514,489,COIL20_old/24/COIL20-0.03226027461062603-12.0.tree,OLD
442,159,181,989,1771,632,COIL20_old/24/COIL20-0.01142198095983249-85.0.tree,OLD
204,69,76,455,804,356,COIL20_old/24/COIL20-0.015679516916313863-62.0.tree,OLD
206,69,76,461,812,361,COIL20_old/24/COIL20-0.014949360514942334-67.0.tree,OLD
203,70,76,454,803,355,COIL20_old/24/COIL20-0.015766380691556725-61.0.tree,OLD
435,157,181,977,1750,627,COIL20_old/24/COIL20-0.013003309207095137-79.0.tree,OLD
448,161,181,997,1787,634,COIL20_old/24/COIL20-0.01134326794097934-87.0.tree,OLD
437,152,172,980,1741,539,COIL20_old/24/COIL20-0.033608281634249615-10.0.tree,OLD
532,164,168,1078,1942,608,COIL20_old/23/COIL20-0.014985119047619844-69.0.tree,OLD
1149,390,404,2407,4350,907,COIL20_old/23/COIL20-0.010857936973695081-90.0.tree,OLD
413,124,135,865,1537,514,COIL20_old/23/COIL20-0.01563280143825857-64.0.tree,OLD
1121,374,398,2344,4237,901,COIL20_old/23/COIL20-0.013301428944035132-80.0.tree,OLD
703,243,254,1420,2620,721,COIL20_old/23/COIL20-0.026936677937998588-11.0.tree,OLD
413,124,135,867,1539,515,COIL20_old/23/COIL20-0.0153878013451072-66.0.tree,OLD
1201,408,426,2519,4554,922,COIL20_old/23/COIL20-0.010802674845367899-92.0.tree,OLD
567,206,203,1186,2162,642,COIL20_old/23/COIL20-0.02474705874133659-25.0.tree,OLD
293,84,95,623,1095,402,COIL20_old/23/COIL20-0.018290239119904406-56.0.tree,OLD
1253,427,445,2621,4746,931,COIL20_old/23/COIL20-0.010433445580891654-97.0.tree,OLD
420,124,136,873,1553,519,COIL20_old/23/COIL20-0.014991802667859377-68.0.tree,OLD
294,84,95,627,1100,405,COIL20_old/23/COIL20-0.016849045662867046-59.0.tree,OLD
1260,429,444,2633,4766,934,COIL20_old/23/COIL20-0.009533124673969773-102.0.tree,OLD
586,196,216,1180,2178,635,COIL20_old/23/COIL20-0.028524002813175464-8.0.tree,OLD
1249,427,443,2613,4732,930,COIL20_old/23/COIL20-0.010499035881958552-96.0.tree,OLD
709,253,247,1463,2672,718,COIL20_old/23/COIL20-0.024993991728146647-21.0.tree,OLD
212,48,50,374,684,241,COIL20_old/23/COIL20-0.020865424025634793-46.0.tree,OLD
299,81,97,631,1108,418,COIL20_old/23/COIL20-0.019239266618228112-51.0.tree,OLD
165,33,40,303,541,181,COIL20_old/23/COIL20-0.023516969874803728-40.0.tree,OLD
425,189,174,982,1770,566,COIL20_old/23/COIL20-0.03913391226991625-4.0.tree,OLD
212,48,50,373,683,240,COIL20_old/23/COIL20-0.021178867184588668-45.0.tree,OLD
545,168,171,1101,1985,621,COIL20_old/23/COIL20-0.014971949754080838-72.0.tree,OLD
1105,371,393,2312,4181,898,COIL20_old/23/COIL20-0.01378387221476951-74.0.tree,OLD
413,124,135,868,1540,516,COIL20_old/23/COIL20-0.015106530386019557-67.0.tree,OLD
293,84,95,624,1096,402,COIL20_old/23/COIL20-0.017533604404202097-57.0.tree,OLD
1253,427,445,2622,4747,931,COIL20_old/23/COIL20-0.010334157724122328-98.0.tree,OLD
581,190,207,1165,2143,625,COIL20_old/23/COIL20-0.029427386075713324-7.0.tree,OLD
597,198,219,1198,2212,643,COIL20_old/23/COIL20-0.028054658972353097-9.0.tree,OLD
1262,430,443,2633,4768,934,COIL20_old/23/COIL20-0.009424638106415695-103.0.tree,OLD
515,190,175,1066,1946,604,COIL20_old/23/COIL20-0.026532970973992653-15.0.tree,OLD
342,136,120,730,1328,451,COIL20_old/23/COIL20-0.03295608139578232-5.0.tree,OLD
219,48,52,384,703,246,COIL20_old/23/COIL20-0.020337895428123587-47.0.tree,OLD
532,164,168,1080,1944,610,COIL20_old/23/COIL20-0.014972310716149573-71.0.tree,OLD
1312,455,461,2754,4982,946,COIL20_old/23/COIL20-0.008520346616737784-113.0.tree,OLD
1201,408,426,2520,4555,922,COIL20_old/23/COIL20-0.010796654929577654-93.0.tree,OLD
1136,383,400,2371,4290,903,COIL20_old/23/COIL20-0.01233853351591041-82.0.tree,OLD
532,164,168,1079,1943,609,COIL20_old/23/COIL20-0.014975501155079063-70.0.tree,OLD
1149,389,404,2403,4345,907,COIL20_old/23/COIL20-0.01123974169088593-87.0.tree,OLD
515,190,175,1067,1947,605,COIL20_old/23/COIL20-0.02632753698114687-16.0.tree,OLD
163,33,39,297,532,176,COIL20_old/23/COIL20-0.02396882452120186-38.0.tree,OLD
585,209,206,1221,2221,659,COIL20_old/23/COIL20-0.024371821205008193-27.0.tree,OLD
1264,431,443,2640,4778,935,COIL20_old/23/COIL20-0.008872447648856252-109.0.tree,OLD
413,124,135,866,1538,515,COIL20_old/23/COIL20-0.015413150197480685-65.0.tree,OLD
278,79,92,601,1050,412,COIL20_old/23/COIL20-0.019146790465012165-52.0.tree,OLD
1143,388,404,2393,4328,906,COIL20_old/23/COIL20-0.011648490479916618-83.0.tree,OLD
1149,389,404,2402,4344,907,COIL20_old/23/COIL20-0.011372692171548071-86.0.tree,OLD
299,81,97,630,1107,417,COIL20_old/23/COIL20-0.019674121115582754-50.0.tree,OLD
1312,455,461,2755,4983,946,COIL20_old/23/COIL20-0.008325927788955079-114.0.tree,OLD
263,78,130,607,1078,355,COIL20_old/23/COIL20-0.05255605391608964-3.0.tree,OLD
1107,371,393,2309,4180,898,COIL20_old/23/COIL20-0.013698021462105137-75.0.tree,OLD
1312,455,461,2753,4981,946,COIL20_old/23/COIL20-0.008771366625680177-112.0.tree,OLD
769,274,286,1598,2927,767,COIL20_old/23/COIL20-0.02674894273045736-12.0.tree,OLD
1124,375,398,2350,4247,902,COIL20_old/23/COIL20-0.012790201859303685-81.0.tree,OLD
1253,427,445,2623,4748,931,COIL20_old/23/COIL20-0.010000570552946508-99.0.tree,OLD
653,227,236,1301,2417,687,COIL20_old/23/COIL20-0.027403029286832192-10.0.tree,OLD
232,94,115,556,997,315,COIL20_old/23/COIL20-0.07159116737461868-2.0.tree,OLD
173,33,40,311,557,192,COIL20_old/23/COIL20-0.02191308732021746-43.0.tree,OLD
1262,431,443,2638,4774,934,COIL20_old/23/COIL20-0.009027661338400661-107.0.tree,OLD
1145,389,404,2398,4336,907,COIL20_old/23/COIL20-0.01154800329756317-84.0.tree,OLD
1314,454,461,2757,4986,947,COIL20_old/23/COIL20-0.008283776734480441-115.0.tree,OLD
1312,455,461,2752,4980,946,COIL20_old/23/COIL20-0.0088203643155233-111.0.tree,OLD
371,108,120,773,1372,464,COIL20_old/23/COIL20-0.015665660630449274-63.0.tree,OLD
567,206,203,1187,2163,642,COIL20_old/23/COIL20-0.024633029659436756-26.0.tree,OLD
1264,431,443,2639,4777,935,COIL20_old/23/COIL20-0.008974949232431806-108.0.tree,OLD
1260,429,444,2632,4765,934,COIL20_old/23/COIL20-0.009682446531037503-101.0.tree,OLD
350,139,143,782,1414,409,COIL20_old/23/COIL20-0.12443260255980348-1.0.tree,OLD
1118,373,397,2332,4220,900,COIL20_old/23/COIL20-0.013556291452418323-76.0.tree,OLD
168,33,39,303,543,184,COIL20_old/23/COIL20-0.02208694295401964-42.0.tree,OLD
1201,408,426,2522,4557,922,COIL20_old/23/COIL20-0.010557302146209924-95.0.tree,OLD
769,274,286,1599,2928,767,COIL20_old/23/COIL20-0.026565399340488405-13.0.tree,OLD
1266,432,443,2643,4784,936,COIL20_old/23/COIL20-0.008830785639764915-110.0.tree,OLD
372,108,120,771,1371,461,COIL20_old/23/COIL20-0.01632807260228042-60.0.tree,OLD
295,84,95,626,1100,403,COIL20_old/23/COIL20-0.017431289123629123-58.0.tree,OLD
371,108,120,771,1370,462,COIL20_old/23/COIL20-0.016202655749311845-61.0.tree,OLD
278,79,92,603,1052,413,COIL20_old/23/COIL20-0.018492308014754766-54.0.tree,OLD
567,206,203,1185,2161,641,COIL20_old/23/COIL20-0.024921019170578373-24.0.tree,OLD
1145,389,404,2399,4337,907,COIL20_old/23/COIL20-0.011381925814144322-85.0.tree,OLD
1200,408,426,2518,4552,922,COIL20_old/23/COIL20-0.010806039943363988-91.0.tree,OLD
1120,374,398,2343,4235,901,COIL20_old/23/COIL20-0.013332005924436119-79.0.tree,OLD
1120,374,398,2342,4234,901,COIL20_old/23/COIL20-0.013523560343542573-78.0.tree,OLD
1149,389,404,2404,4346,907,COIL20_old/23/COIL20-0.011031780963559001-88.0.tree,OLD
601,212,204,1227,2244,662,COIL20_old/23/COIL20-0.02552653886280687-17.0.tree,OLD
171,35,40,307,553,182,COIL20_old/23/COIL20-0.023724534708250422-39.0.tree,OLD
251,61,74,495,881,325,COIL20_old/23/COIL20-0.02016939600566392-48.0.tree,OLD
1262,431,443,2636,4772,934,COIL20_old/23/COIL20-0.00908819817050488-105.0.tree,OLD
242,60,73,488,863,324,COIL20_old/23/COIL20-0.01983906913704575-49.0.tree,OLD
293,84,95,622,1094,402,COIL20_old/23/COIL20-0.018458598815112415-55.0.tree,OLD
278,79,92,602,1051,412,COIL20_old/23/COIL20-0.018894280032044075-53.0.tree,OLD
371,108,120,772,1371,463,COIL20_old/23/COIL20-0.01589718868768164-62.0.tree,OLD
1149,389,404,2405,4347,907,COIL20_old/23/COIL20-0.010906620277218337-89.0.tree,OLD
165,33,40,304,542,182,COIL20_old/23/COIL20-0.022386774349801186-41.0.tree,OLD
621,210,223,1223,2277,647,COIL20_old/23/COIL20-0.030908005905805724-6.0.tree,OLD
1262,431,443,2637,4773,934,COIL20_old/23/COIL20-0.009084215943811258-106.0.tree,OLD
545,168,171,1102,1986,622,COIL20_old/23/COIL20-0.014684193121693001-73.0.tree,OLD
1260,429,444,2631,4764,934,COIL20_old/23/COIL20-0.00994507554586771-100.0.tree,OLD
203,46,49,363,661,234,COIL20_old/23/COIL20-0.021686577800134832-44.0.tree,OLD
1262,430,443,2634,4769,934,COIL20_old/23/COIL20-0.009284910854012618-104.0.tree,OLD
227,91,77,496,891,340,COIL20_old/4/COIL20-0.016409358931365803-54.0.tree,OLD
1001,343,345,2167,3856,882,COIL20_old/4/COIL20-0.005747668883673063-146.0.tree,OLD
50,13,33,117,213,79,COIL20_old/4/COIL20-0.032220429055816346-18.0.tree,OLD
229,91,78,510,908,350,COIL20_old/4/COIL20-0.01315582150309308-67.0.tree,OLD
141,46,45,317,549,241,COIL20_old/4/COIL20-0.020534363588941396-44.0.tree,OLD
741,250,269,1628,2888,787,COIL20_old/4/COIL20-0.007191191128250063-121.0.tree,OLD
393,153,147,868,1561,547,COIL20_old/4/COIL20-0.012006681291452659-74.0.tree,OLD
229,91,78,508,906,348,COIL20_old/4/COIL20-0.013753784279752768-65.0.tree,OLD
506,166,186,1101,1959,648,COIL20_old/4/COIL20-0.008531198766674186-98.0.tree,OLD
225,91,77,492,885,339,COIL20_old/4/COIL20-0.017177486213577065-51.0.tree,OLD
480,164,175,1030,1849,626,COIL20_old/4/COIL20-0.010652805723228853-84.0.tree,OLD
984,344,343,2149,3820,879,COIL20_old/4/COIL20-0.0057798643714135345-144.0.tree,OLD
481,161,176,1034,1852,627,COIL20_old/4/COIL20-0.009795555741857864-88.0.tree,OLD
141,46,45,318,550,242,COIL20_old/4/COIL20-0.020480626816454628-45.0.tree,OLD
635,213,228,1386,2462,742,COIL20_old/4/COIL20-0.007322907351516417-117.0.tree,OLD
635,213,228,1385,2461,742,COIL20_old/4/COIL20-0.007388975054028801-116.0.tree,OLD
393,153,147,867,1560,546,COIL20_old/4/COIL20-0.01225778280795764-73.0.tree,OLD
211,87,71,457,826,332,COIL20_old/4/COIL20-0.018614045383410882-49.0.tree,OLD
916,312,326,1993,3547,858,COIL20_old/4/COIL20-0.006492391851105173-135.0.tree,OLD
578,195,213,1274,2260,712,COIL20_old/4/COIL20-0.007506683620239429-111.0.tree,OLD
916,312,326,1992,3546,858,COIL20_old/4/COIL20-0.006603579812206384-134.0.tree,OLD
488,163,176,1049,1876,630,COIL20_old/4/COIL20-0.008789950350249764-95.0.tree,OLD
65,24,30,180,299,120,COIL20_old/4/COIL20-0.024785460447872665-37.0.tree,OLD
498,166,177,1066,1907,635,COIL20_old/4/COIL20-0.008701980400923848-96.0.tree,OLD
585,193,215,1270,2263,712,COIL20_old/4/COIL20-0.008071368022952996-104.0.tree,OLD
73,21,32,155,281,115,COIL20_old/4/COIL20-0.03619791666666633-15.0.tree,OLD
926,317,328,2019,3590,861,COIL20_old/4/COIL20-0.006137461342127171-139.0.tree,OLD
480,161,176,1033,1850,626,COIL20_old/4/COIL20-0.009760705436321127-89.0.tree,OLD
926,317,328,2018,3589,860,COIL20_old/4/COIL20-0.006231742305686572-138.0.tree,OLD
582,193,216,1272,2263,712,COIL20_old/4/COIL20-0.007985191240033052-107.0.tree,OLD
480,161,176,1034,1851,626,COIL20_old/4/COIL20-0.009652894217155261-90.0.tree,OLD
304,125,113,670,1212,451,COIL20_old/4/COIL20-0.012747701486697849-69.0.tree,OLD
624,209,226,1366,2425,739,COIL20_old/4/COIL20-0.007408618376927967-114.0.tree,OLD
1025,355,361,2254,3995,892,COIL20_old/4/COIL20-0.005367645688948874-155.0.tree,OLD
582,194,216,1275,2267,713,COIL20_old/4/COIL20-0.007607508476785818-109.0.tree,OLD
1020,355,359,2246,3980,891,COIL20_old/4/COIL20-0.005382631436769314-154.0.tree,OLD
481,161,176,1037,1855,628,COIL20_old/4/COIL20-0.009554468011774231-91.0.tree,OLD
476,164,174,1025,1839,623,COIL20_old/4/COIL20-0.010662679782398432-83.0.tree,OLD
228,91,78,505,902,346,COIL20_old/4/COIL20-0.0141617762128326-62.0.tree,OLD
678,228,239,1473,2618,765,COIL20_old/4/COIL20-0.007320764866979634-118.0.tree,OLD
1001,343,345,2170,3859,883,COIL20_old/4/COIL20-0.005562670001489911-149.0.tree,OLD
75,24,30,190,319,131,COIL20_old/4/COIL20-0.02183567842238676-42.0.tree,OLD
541,176,196,1161,2074,671,COIL20_old/4/COIL20-0.00823786468812876-100.0.tree,OLD
228,91,78,503,900,344,COIL20_old/4/COIL20-0.014881802388405196-60.0.tree,OLD
393,153,147,869,1562,548,COIL20_old/4/COIL20-0.011950999981369892-75.0.tree,OLD
585,193,215,1271,2264,712,COIL20_old/4/COIL20-0.008029030665474113-105.0.tree,OLD
229,91,78,511,909,351,COIL20_old/4/COIL20-0.013001504396750907-68.0.tree,OLD
158,81,48,307,594,200,COIL20_old/4/COIL20-0.04285190308517828-11.0.tree,OLD
55,19,32,130,236,96,COIL20_old/4/COIL20-0.029494373649303185-21.0.tree,OLD
927,317,328,2024,3596,862,COIL20_old/4/COIL20-0.005869150085699604-143.0.tree,OLD
486,163,176,1041,1866,629,COIL20_old/4/COIL20-0.009216537651837164-92.0.tree,OLD
90,31,32,163,316,106,COIL20_old/4/COIL20-0.048149708435799965-9.0.tree,OLD
819,281,292,1783,3175,816,COIL20_old/4/COIL20-0.00701476218421454-125.0.tree,OLD
142,28,45,220,435,110,COIL20_old/4/COIL20-0.06357834507042243-5.0.tree,OLD
578,195,213,1276,2262,712,COIL20_old/4/COIL20-0.0074234178217447155-113.0.tree,OLD
408,146,151,892,1597,560,COIL20_old/4/COIL20-0.011379666890230844-78.0.tree,OLD
1008,349,356,2228,3941,890,COIL20_old/4/COIL20-0.005336323496534345-156.0.tree,OLD
141,46,45,319,551,243,COIL20_old/4/COIL20-0.020192683881064266-46.0.tree,OLD
54,16,20,111,201,55,COIL20_old/4/COIL20-0.03819171976302205-14.0.tree,OLD
909,310,325,1981,3525,855,COIL20_old/4/COIL20-0.0067925492771444-130.0.tree,OLD
819,281,292,1784,3176,817,COIL20_old/4/COIL20-0.006988155786570138-126.0.tree,OLD
228,91,78,501,898,343,COIL20_old/4/COIL20-0.015621122568745649-58.0.tree,OLD
53,13,34,127,227,89,COIL20_old/4/COIL20-0.03071718505477211-20.0.tree,OLD
758,261,275,1672,2966,793,COIL20_old/4/COIL20-0.0070306445152393815-124.0.tree,OLD
744,252,269,1637,2902,789,COIL20_old/4/COIL20-0.007137792029958012-123.0.tree,OLD
903,309,323,1964,3499,854,COIL20_old/4/COIL20-0.006910013320665209-129.0.tree,OLD
227,91,78,500,896,342,COIL20_old/4/COIL20-0.015653283124673678-57.0.tree,OLD
85,14,29,129,257,83,COIL20_old/4/COIL20-0.045242531578358725-10.0.tree,OLD
229,91,78,509,907,349,COIL20_old/4/COIL20-0.013473840729563258-66.0.tree,OLD
541,176,196,1162,2075,671,COIL20_old/4/COIL20-0.008217522728966586-101.0.tree,OLD
66,24,30,181,301,121,COIL20_old/4/COIL20-0.02459157724122485-38.0.tree,OLD
1001,343,345,2169,3858,883,COIL20_old/4/COIL20-0.005574162568000196-148.0.tree,OLD
105,40,43,250,438,177,COIL20_old/4/COIL20-0.025722774144869398-29.0.tree,OLD
135,24,42,207,408,121,COIL20_old/4/COIL20-0.08231420933005373-3.0.tree,OLD
991,347,347,2168,3853,881,COIL20_old/4/COIL20-0.005779584916908054-145.0.tree,OLD
46,17,20,104,187,86,COIL20_old/4/COIL20-0.028911792514346113-22.0.tree,OLD
46,17,20,106,189,88,COIL20_old/4/COIL20-0.028855971477009468-24.0.tree,OLD
916,312,326,1995,3549,858,COIL20_old/4/COIL20-0.006380540185557504-137.0.tree,OLD
68,28,29,184,309,119,COIL20_old/4/COIL20-0.025665660630448894-36.0.tree,OLD
535,173,195,1158,2061,669,COIL20_old/4/COIL20-0.008093817534838454-103.0.tree,OLD
926,317,328,2020,3591,861,COIL20_old/4/COIL20-0.006133222948804251-140.0.tree,OLD
1017,350,359,2236,3962,890,COIL20_old/4/COIL20-0.005432979823384976-151.0.tree,OLD
909,310,325,1982,3526,855,COIL20_old/4/COIL20-0.0067869951188612165-131.0.tree,OLD
31,10,17,80,138,52,COIL20_old/4/COIL20-0.0395872224085253-13.0.tree,OLD
408,146,151,890,1595,559,COIL20_old/4/COIL20-0.011511359825619238-76.0.tree,OLD
819,281,292,1785,3177,817,COIL20_old/4/COIL20-0.006935478612414947-127.0.tree,OLD
228,91,78,502,899,343,COIL20_old/4/COIL20-0.015223656755347148-59.0.tree,OLD
153,25,47,236,461,129,COIL20_old/4/COIL20-0.06835239445934954-4.0.tree,OLD
123,23,40,212,398,123,COIL20_old/4/COIL20-0.05060784847976729-8.0.tree,OLD
225,91,77,493,886,339,COIL20_old/4/COIL20-0.016760237350026796-52.0.tree,OLD
927,317,328,2023,3595,862,COIL20_old/4/COIL20-0.005929663629927973-142.0.tree,OLD
217,89,72,469,847,343,COIL20_old/4/COIL20-0.017494608856845006-50.0.tree,OLD
541,176,196,1160,2073,670,COIL20_old/4/COIL20-0.008316298252478371-99.0.tree,OLD
582,194,216,1274,2266,713,COIL20_old/4/COIL20-0.00782091856695738-108.0.tree,OLD
229,91,78,506,904,346,COIL20_old/4/COIL20-0.01416175292495725-63.0.tree,OLD
488,163,176,1047,1874,630,COIL20_old/4/COIL20-0.008979606807510976-93.0.tree,OLD
481,161,176,1032,1850,626,COIL20_old/4/COIL20-0.010047076440122926-86.0.tree,OLD
406,146,151,892,1595,562,COIL20_old/4/COIL20-0.010915982003130209-79.0.tree,OLD
481,161,176,1031,1849,625,COIL20_old/4/COIL20-0.010237105503390742-85.0.tree,OLD
393,153,147,866,1559,546,COIL20_old/4/COIL20-0.012418690383038444-72.0.tree,OLD
228,91,78,504,901,345,COIL20_old/4/COIL20-0.01434896415530218-61.0.tree,OLD
183,61,78,386,708,293,COIL20_old/4/COIL20-0.03435000046575809-16.0.tree,OLD
143,46,46,325,560,249,COIL20_old/4/COIL20-0.019699143937700503-47.0.tree,OLD
499,166,177,1069,1911,637,COIL20_old/4/COIL20-0.008701002310157635-97.0.tree,OLD
406,146,151,893,1596,563,COIL20_old/4/COIL20-0.010761443661971848-80.0.tree,OLD
195,73,68,420,756,313,COIL20_old/4/COIL20-0.018778539291303742-48.0.tree,OLD
740,250,269,1625,2884,786,COIL20_old/4/COIL20-0.007203964527908113-120.0.tree,OLD
453,159,165,986,1763,599,COIL20_old/4/COIL20-0.010699323254340976-81.0.tree,OLD
46,17,20,105,188,87,COIL20_old/4/COIL20-0.028904561629033765-23.0.tree,OLD
113,26,40,194,373,119,COIL20_old/4/COIL20-0.053554859248081677-7.0.tree,OLD
120,18,54,203,395,104,COIL20_old/4/COIL20-0.11204163639242809-2.0.tree,OLD
229,91,78,507,905,347,COIL20_old/4/COIL20-0.013910197294880411-64.0.tree,OLD
251,86,97,472,906,268,COIL20_old/4/COIL20-0.14678810129294279-1.0.tree,OLD
1001,343,345,2168,3857,883,COIL20_old/4/COIL20-0.005660968123555654-147.0.tree,OLD
225,91,77,494,887,340,COIL20_old/4/COIL20-0.016531794936284483-53.0.tree,OLD
105,35,41,262,443,197,COIL20_old/4/COIL20-0.020696947891050643-43.0.tree,OLD
1017,350,359,2235,3961,890,COIL20_old/4/COIL20-0.0055439931254195884-150.0.tree,OLD
53,13,24,109,199,61,COIL20_old/4/COIL20-0.03330338512556785-17.0.tree,OLD
391,152,148,858,1549,541,COIL20_old/4/COIL20-0.012723901278038519-70.0.tree,OLD
408,146,151,891,1596,560,COIL20_old/4/COIL20-0.011429572807214405-77.0.tree,OLD
1020,354,359,2244,3977,891,COIL20_old/4/COIL20-0.005387114352782663-153.0.tree,OLD
901,309,323,1963,3496,854,COIL20_old/4/COIL20-0.006910176335793106-128.0.tree,OLD
488,163,176,1048,1875,630,COIL20_old/4/COIL20-0.008907891795216005-94.0.tree,OLD
58,32,21,125,236,64,COIL20_old/4/COIL20-0.04043937234518197-12.0.tree,OLD
909,311,325,1984,3529,855,COIL20_old/4/COIL20-0.006769121674491896-132.0.tree,OLD
227,91,78,499,895,341,COIL20_old/4/COIL20-0.015970743442134228-56.0.tree,OLD
714,245,259,1570,2788,783,COIL20_old/4/COIL20-0.007279091213950928-119.0.tree,OLD
535,173,195,1157,2060,669,COIL20_old/4/COIL20-0.008136224755942334-102.0.tree,OLD
470,163,173,1018,1824,622,COIL20_old/4/COIL20-0.010670946978165674-82.0.tree,OLD
624,209,226,1367,2426,739,COIL20_old/4/COIL20-0.007390907947687153-115.0.tree,OLD
1017,350,359,2237,3963,890,COIL20_old/4/COIL20-0.00540232133541918-152.0.tree,OLD
78,14,22,113,227,65,COIL20_old/4/COIL20-0.058788797600417386-6.0.tree,OLD
66,24,30,183,303,123,COIL20_old/4/COIL20-0.0235595750428495-40.0.tree,OLD
741,251,269,1630,2891,787,COIL20_old/4/COIL20-0.007154664095685992-122.0.tree,OLD
481,161,176,1033,1851,626,COIL20_old/4/COIL20-0.009889557250913561-87.0.tree,OLD
916,312,326,1994,3548,858,COIL20_old/4/COIL20-0.00640272188687685-136.0.tree,OLD
578,195,213,1275,2261,712,COIL20_old/4/COIL20-0.007484630002235093-112.0.tree,OLD
67,24,30,185,306,126,COIL20_old/4/COIL20-0.022351714453386518-41.0.tree,OLD
927,317,328,2022,3594,862,COIL20_old/4/COIL20-0.005971220843579705-141.0.tree,OLD
585,193,215,1272,2265,713,COIL20_old/4/COIL20-0.00802453610552073-106.0.tree,OLD
229,92,77,498,896,340,COIL20_old/4/COIL20-0.016166186936433014-55.0.tree,OLD
50,13,33,118,214,80,COIL20_old/4/COIL20-0.030942215794768746-19.0.tree,OLD
577,195,213,1272,2257,712,COIL20_old/4/COIL20-0.007583661692375954-110.0.tree,OLD
391,152,148,859,1550,541,COIL20_old/4/COIL20-0.012612084544302349-71.0.tree,OLD
66,24,30,182,302,122,COIL20_old/4/COIL20-0.024104127077279325-39.0.tree,OLD
529,207,235,1235,2206,642,COIL20_old/15/COIL20-0.023466761215441-20.0.tree,OLD
868,355,376,2012,3611,806,COIL20_old/15/COIL20-0.027410877300842573-9.0.tree,OLD
1165,464,496,2588,4713,923,COIL20_old/15/COIL20-0.019944702939862113-49.0.tree,OLD
1302,505,557,2894,5258,941,COIL20_old/15/COIL20-0.013820096504955304-68.0.tree,OLD
845,338,349,1910,3442,826,COIL20_old/15/COIL20-0.025837711453908396-11.0.tree,OLD
813,323,334,1823,3293,812,COIL20_old/15/COIL20-0.02529059775318615-12.0.tree,OLD
475,185,190,1023,1873,568,COIL20_old/15/COIL20-0.03493926522095592-5.0.tree,OLD
1391,530,579,3064,5564,961,COIL20_old/15/COIL20-0.011447714062150505-85.0.tree,OLD
1414,534,587,3132,5667,967,COIL20_old/15/COIL20-0.009283839611744726-103.0.tree,OLD
1401,530,581,3099,5611,966,COIL20_old/15/COIL20-0.010211244317757218-96.0.tree,OLD
819,332,341,1864,3356,812,COIL20_old/15/COIL20-0.024775213782695094-14.0.tree,OLD
1306,498,558,2903,5265,948,COIL20_old/15/COIL20-0.012401981332438083-77.0.tree,OLD
1208,470,510,2676,4864,930,COIL20_old/15/COIL20-0.015867508290483168-62.0.tree,OLD
594,224,225,1270,2313,678,COIL20_old/15/COIL20-0.021956426056337852-32.0.tree,OLD
1414,534,587,3131,5666,967,COIL20_old/15/COIL20-0.009495293520381476-102.0.tree,OLD
564,213,209,1199,2185,652,COIL20_old/15/COIL20-0.02287138339295064-27.0.tree,OLD
1385,529,579,3063,5556,963,COIL20_old/15/COIL20-0.011098803468960583-88.0.tree,OLD
1248,479,544,2784,5055,928,COIL20_old/15/COIL20-0.015064775225425597-63.0.tree,OLD
561,210,209,1197,2177,653,COIL20_old/15/COIL20-0.022500721924138767-29.0.tree,OLD
861,350,354,1955,3520,837,COIL20_old/15/COIL20-0.026575250111780968-10.0.tree,OLD
1293,502,553,2872,5220,946,COIL20_old/15/COIL20-0.013143024815559456-74.0.tree,OLD
578,216,221,1259,2274,673,COIL20_old/15/COIL20-0.02121197089947091-36.0.tree,OLD
1165,464,496,2591,4716,923,COIL20_old/15/COIL20-0.018506455399059596-52.0.tree,OLD
1404,533,584,3102,5623,966,COIL20_old/15/COIL20-0.010824227774050621-91.0.tree,OLD
823,295,371,1851,3340,798,COIL20_old/15/COIL20-0.03991182045979663-4.0.tree,OLD
1384,527,582,3055,5548,960,COIL20_old/15/COIL20-0.012013132032938079-81.0.tree,OLD
1407,531,586,3118,5642,966,COIL20_old/15/COIL20-0.009874874245472343-99.0.tree,OLD
1302,504,557,2898,5261,943,COIL20_old/15/COIL20-0.013373341903272051-72.0.tree,OLD
355,169,145,818,1487,472,COIL20_old/15/COIL20-0.07214880719502254-2.0.tree,OLD
557,210,209,1194,2170,652,COIL20_old/15/COIL20-0.0225078945897616-28.0.tree,OLD
845,338,350,1913,3446,827,COIL20_old/15/COIL20-0.02510253651538863-13.0.tree,OLD
594,224,225,1272,2315,678,COIL20_old/15/COIL20-0.021684307232282485-34.0.tree,OLD
1293,502,553,2873,5221,946,COIL20_old/15/COIL20-0.012718230680377973-75.0.tree,OLD
1239,477,542,2766,5024,929,COIL20_old/15/COIL20-0.014836134864744333-64.0.tree,OLD
559,229,214,1294,2296,670,COIL20_old/15/COIL20-0.015896792793800574-54.0.tree,OLD
1385,529,579,3061,5554,962,COIL20_old/15/COIL20-0.011165453368358003-86.0.tree,OLD
1320,501,566,2940,5327,953,COIL20_old/15/COIL20-0.012223642782621835-79.0.tree,OLD
568,213,216,1234,2231,661,COIL20_old/15/COIL20-0.021244201319025158-35.0.tree,OLD
1118,445,472,2474,4509,911,COIL20_old/15/COIL20-0.02045771154706011-48.0.tree,OLD
594,224,225,1271,2314,678,COIL20_old/15/COIL20-0.021813345349877444-33.0.tree,OLD
1307,498,558,2905,5268,948,COIL20_old/15/COIL20-0.012229802425664127-78.0.tree,OLD
1165,464,496,2589,4714,923,COIL20_old/15/COIL20-0.019692588400774258-50.0.tree,OLD
1414,534,587,3133,5668,967,COIL20_old/15/COIL20-0.008872272989791485-104.0.tree,OLD
1405,533,584,3105,5627,967,COIL20_old/15/COIL20-0.010439651799686978-93.0.tree,OLD
1409,531,586,3121,5647,966,COIL20_old/15/COIL20-0.00951450601758691-101.0.tree,OLD
1413,530,587,3121,5651,968,COIL20_old/15/COIL20-0.010117219520828336-97.0.tree,OLD
1166,465,496,2593,4720,923,COIL20_old/15/COIL20-0.018278513674640506-53.0.tree,OLD
1165,464,496,2590,4715,923,COIL20_old/15/COIL20-0.019296054102392324-51.0.tree,OLD
1404,533,584,3103,5624,967,COIL20_old/15/COIL20-0.010443028541620047-92.0.tree,OLD
547,227,275,1301,2350,652,COIL20_old/15/COIL20-0.05010689134808888-3.0.tree,OLD
562,210,211,1207,2190,655,COIL20_old/15/COIL20-0.022324886820925594-30.0.tree,OLD
1405,533,584,3106,5628,967,COIL20_old/15/COIL20-0.010375272468142405-94.0.tree,OLD
1306,501,557,2898,5262,949,COIL20_old/15/COIL20-0.012586246646545785-76.0.tree,OLD
1406,531,586,3117,5640,966,COIL20_old/15/COIL20-0.01002362554959313-98.0.tree,OLD
839,337,351,1913,3440,825,COIL20_old/15/COIL20-0.0245789901445711-16.0.tree,OLD
1404,533,584,3101,5622,966,COIL20_old/15/COIL20-0.01083507992398769-90.0.tree,OLD
1128,446,492,2554,4620,911,COIL20_old/15/COIL20-0.020585806505699578-47.0.tree,OLD
1404,533,584,3100,5621,965,COIL20_old/15/COIL20-0.010924284130709505-89.0.tree,OLD
1327,510,574,2955,5366,941,COIL20_old/15/COIL20-0.014419363402637164-66.0.tree,OLD
768,312,316,1720,3116,767,COIL20_old/15/COIL20-0.028625037260599617-7.0.tree,OLD
561,212,212,1208,2193,660,COIL20_old/15/COIL20-0.022884657481927917-26.0.tree,OLD
1393,530,582,3065,5570,962,COIL20_old/15/COIL20-0.011856940252626846-82.0.tree,OLD
834,335,357,1894,3420,787,COIL20_old/15/COIL20-0.027807190364408818-8.0.tree,OLD
322,157,146,741,1366,401,COIL20_old/15/COIL20-0.1178531722743868-1.0.tree,OLD
594,225,226,1278,2323,681,COIL20_old/15/COIL20-0.022225005123332864-31.0.tree,OLD
1327,509,568,2958,5362,954,COIL20_old/15/COIL20-0.012221931123779617-80.0.tree,OLD
1401,530,581,3098,5610,966,COIL20_old/15/COIL20-0.010333039906102681-95.0.tree,OLD
1393,530,582,3066,5571,962,COIL20_old/15/COIL20-0.011670800264551584-83.0.tree,OLD
1302,505,557,2895,5259,941,COIL20_old/15/COIL20-0.013648103901185593-69.0.tree,OLD
1292,502,553,2870,5217,946,COIL20_old/15/COIL20-0.01331287493479355-73.0.tree,OLD
639,265,274,1499,2677,719,COIL20_old/15/COIL20-0.030763504638944894-6.0.tree,OLD
1304,506,557,2898,5265,942,COIL20_old/15/COIL20-0.013563103155972867-71.0.tree,OLD
1304,506,557,2897,5264,941,COIL20_old/15/COIL20-0.013647614855802404-70.0.tree,OLD
1127,444,492,2551,4614,911,COIL20_old/15/COIL20-0.020633721309337383-46.0.tree,OLD
1308,506,560,2906,5280,941,COIL20_old/15/COIL20-0.014055862955510812-67.0.tree,OLD
1397,530,583,3074,5584,962,COIL20_old/15/COIL20-0.011513653681346714-84.0.tree,OLD
1385,529,579,3062,5555,962,COIL20_old/15/COIL20-0.011129031131231648-87.0.tree,OLD
1127,444,492,2550,4613,911,COIL20_old/15/COIL20-0.02109365684849901-45.0.tree,OLD
1230,472,537,2742,4981,926,COIL20_old/15/COIL20-0.014436468347120479-65.0.tree,OLD
588,187,207,1249,2231,696,COIL20_old/3/COIL20-0.014377806188985098-60.0.tree,OLD
499,174,194,1102,1969,666,COIL20_old/3/COIL20-0.02132914384454887-42.0.tree,OLD
529,163,197,1117,2006,657,COIL20_old/3/COIL20-0.01877807353379507-48.0.tree,OLD
581,193,198,1237,2209,701,COIL20_old/3/COIL20-0.012762629014829552-70.0.tree,OLD
579,193,197,1229,2198,696,COIL20_old/3/COIL20-0.01335876369327016-66.0.tree,OLD
495,168,190,1081,1934,657,COIL20_old/3/COIL20-0.02122416210224254-43.0.tree,OLD
528,168,197,1121,2014,667,COIL20_old/3/COIL20-0.0203371036403594-44.0.tree,OLD
579,193,197,1231,2200,697,COIL20_old/3/COIL20-0.013043236269468683-68.0.tree,OLD
632,208,246,1370,2456,640,COIL20_old/3/COIL20-0.027371637230792334-13.0.tree,OLD
521,158,193,1104,1976,650,COIL20_old/3/COIL20-0.01774807409270418-50.0.tree,OLD
590,185,207,1253,2235,696,COIL20_old/3/COIL20-0.013546906438632711-64.0.tree,OLD
388,137,176,880,1581,450,COIL20_old/3/COIL20-0.033066908394813466-7.0.tree,OLD
444,151,214,1030,1839,550,COIL20_old/3/COIL20-0.06168812644384758-3.0.tree,OLD
499,174,194,1102,1969,666,COIL20_old/3/COIL20-0.021609227121990926-41.0.tree,OLD
543,170,198,1137,2048,677,COIL20_old/3/COIL20-0.019299384268575026-47.0.tree,OLD
562,180,191,1185,2118,677,COIL20_old/3/COIL20-0.013474504434011492-65.0.tree,OLD
560,177,199,1183,2119,671,COIL20_old/3/COIL20-0.015241262389148913-55.0.tree,OLD
503,158,184,1072,1917,632,COIL20_old/3/COIL20-0.015782880151278156-54.0.tree,OLD
587,186,207,1246,2226,695,COIL20_old/3/COIL20-0.014663944314031896-58.0.tree,OLD
603,197,208,1275,2283,713,COIL20_old/3/COIL20-0.012063561927118216-74.0.tree,OLD
357,147,183,864,1551,453,COIL20_old/3/COIL20-0.043170236697965214-4.0.tree,OLD
845,309,312,1835,3301,731,COIL20_old/3/COIL20-0.024925013041209754-18.0.tree,OLD
492,164,227,1130,2013,574,COIL20_old/3/COIL20-0.031137601069378518-9.0.tree,OLD
862,317,321,1889,3389,741,COIL20_old/3/COIL20-0.02508844735077126-17.0.tree,OLD
579,193,197,1230,2199,696,COIL20_old/3/COIL20-0.013143269338252606-67.0.tree,OLD
866,303,398,2057,3624,846,COIL20_old/3/COIL20-0.03489671827259799-6.0.tree,OLD
520,158,194,1104,1976,651,COIL20_old/3/COIL20-0.018131078135479373-49.0.tree,OLD
704,247,273,1569,2793,708,COIL20_old/3/COIL20-0.02936684924361016-11.0.tree,OLD
851,304,317,1856,3328,746,COIL20_old/3/COIL20-0.024454155488486007-20.0.tree,OLD
349,220,179,931,1679,444,COIL20_old/3/COIL20-0.1332566929353906-1.0.tree,OLD
541,172,199,1136,2048,672,COIL20_old/3/COIL20-0.019771021965123536-46.0.tree,OLD
587,186,207,1247,2227,696,COIL20_old/3/COIL20-0.014550951542589508-59.0.tree,OLD
610,197,212,1295,2314,719,COIL20_old/3/COIL20-0.011349427584022076-76.0.tree,OLD
668,264,265,1479,2676,653,COIL20_old/3/COIL20-0.0896514270810051-2.0.tree,OLD
581,193,198,1238,2210,701,COIL20_old/3/COIL20-0.012704898371711848-71.0.tree,OLD
396,141,183,907,1627,461,COIL20_old/3/COIL20-0.03244080222073176-8.0.tree,OLD
604,196,208,1275,2283,714,COIL20_old/3/COIL20-0.011706267698785577-75.0.tree,OLD
886,321,335,1946,3488,781,COIL20_old/3/COIL20-0.02374760134883369-27.0.tree,OLD
610,197,212,1296,2315,719,COIL20_old/3/COIL20-0.011052705119605988-77.0.tree,OLD
614,205,210,1292,2321,715,COIL20_old/3/COIL20-0.012288778970116765-73.0.tree,OLD
849,310,318,1857,3334,744,COIL20_old/3/COIL20-0.02477436377524389-19.0.tree,OLD
503,177,228,1159,2067,586,COIL20_old/3/COIL20-0.03002121525448992-10.0.tree,OLD
503,158,184,1071,1916,632,COIL20_old/3/COIL20-0.01624905684104594-53.0.tree,OLD
614,205,210,1291,2320,715,COIL20_old/3/COIL20-0.012441640584245128-72.0.tree,OLD
561,179,199,1186,2125,670,COIL20_old/3/COIL20-0.014999988356062477-56.0.tree,OLD
590,185,207,1252,2234,695,COIL20_old/3/COIL20-0.013592341083538018-63.0.tree,OLD
499,174,194,1101,1968,665,COIL20_old/3/COIL20-0.021931123779715123-40.0.tree,OLD
589,187,207,1251,2234,695,COIL20_old/3/COIL20-0.01367430276101067-61.0.tree,OLD
589,187,207,1252,2235,695,COIL20_old/3/COIL20-0.013663811573142393-62.0.tree,OLD
519,158,191,1100,1968,649,COIL20_old/3/COIL20-0.01741187867948496-51.0.tree,OLD
784,289,304,1745,3122,703,COIL20_old/3/COIL20-0.026232860123705237-16.0.tree,OLD
685,219,322,1610,2836,710,COIL20_old/3/COIL20-0.038426310175869394-5.0.tree,OLD
579,193,197,1232,2201,698,COIL20_old/3/COIL20-0.012963929409791741-69.0.tree,OLD
561,179,199,1187,2126,671,COIL20_old/3/COIL20-0.014991150607348513-57.0.tree,OLD
519,158,191,1101,1969,649,COIL20_old/3/COIL20-0.016752098237572843-52.0.tree,OLD
500,173,194,1099,1966,664,COIL20_old/3/COIL20-0.023027586817199075-39.0.tree,OLD
828,312,319,1834,3293,736,COIL20_old/3/COIL20-0.026534158655638684-15.0.tree,OLD
531,168,197,1123,2019,668,COIL20_old/3/COIL20-0.020217497112303584-45.0.tree,OLD
568,197,216,1244,2225,624,COIL20_old/3/COIL20-0.028432446531038436-12.0.tree,OLD
387,162,147,906,1602,580,COIL20_old/12/COIL20-0.013907251378642627-66.0.tree,OLD
77,51,59,257,444,130,COIL20_old/12/COIL20-0.09856089080780989-2.0.tree,OLD
148,42,40,216,446,103,COIL20_old/12/COIL20-0.040781820552947545-11.0.tree,OLD
97,31,35,238,401,152,COIL20_old/12/COIL20-0.01787646014978772-55.0.tree,OLD
571,242,217,1310,2340,738,COIL20_old/12/COIL20-0.010649126238914619-81.0.tree,OLD
61,33,27,174,295,98,COIL20_old/12/COIL20-0.023643329886727737-40.0.tree,OLD
574,238,214,1292,2318,726,COIL20_old/12/COIL20-0.011503523455547227-77.0.tree,OLD
73,44,40,196,353,128,COIL20_old/12/COIL20-0.0866081209479092-3.0.tree,OLD
181,77,59,416,733,303,COIL20_old/12/COIL20-0.014147489101274169-64.0.tree,OLD
70,11,10,105,196,65,COIL20_old/12/COIL20-0.03081134957895454-19.0.tree,OLD
175,73,53,386,687,278,COIL20_old/12/COIL20-0.014519838941053353-62.0.tree,OLD
574,238,214,1293,2319,727,COIL20_old/12/COIL20-0.011321645148669346-78.0.tree,OLD
390,165,148,913,1616,583,COIL20_old/12/COIL20-0.01389650402414444-67.0.tree,OLD
230,58,64,347,699,200,COIL20_old/12/COIL20-0.058725233344511685-6.0.tree,OLD
58,4,7,74,143,44,COIL20_old/12/COIL20-0.03219733912735623-18.0.tree,OLD
563,238,214,1283,2298,726,COIL20_old/12/COIL20-0.01220096039198093-76.0.tree,OLD
97,31,35,237,400,151,COIL20_old/12/COIL20-0.01829863439898688-54.0.tree,OLD
103,17,19,150,289,103,COIL20_old/12/COIL20-0.03346359406438537-17.0.tree,OLD
96,32,32,238,398,155,COIL20_old/12/COIL20-0.01581887156270856-58.0.tree,OLD
153,44,42,200,439,103,COIL20_old/12/COIL20-0.04610142335494399-9.0.tree,OLD
87,31,36,224,378,141,COIL20_old/12/COIL20-0.019124387528877518-51.0.tree,OLD
90,33,36,230,389,145,COIL20_old/12/COIL20-0.019377491802667957-50.0.tree,OLD
107,35,32,154,328,91,COIL20_old/12/COIL20-0.036762053804306694-13.0.tree,OLD
591,240,214,1310,2355,734,COIL20_old/12/COIL20-0.010752186731500302-79.0.tree,OLD
424,177,157,980,1738,612,COIL20_old/12/COIL20-0.012258795830538571-75.0.tree,OLD
96,30,32,235,393,148,COIL20_old/12/COIL20-0.017678781019450196-56.0.tree,OLD
92,37,30,211,370,134,COIL20_old/12/COIL20-0.022686384510767654-44.0.tree,OLD
153,68,54,372,647,264,COIL20_old/12/COIL20-0.015719898092257212-59.0.tree,OLD
87,36,29,199,351,118,COIL20_old/12/COIL20-0.0233693014568897-42.0.tree,OLD
352,132,136,726,1346,366,COIL20_old/12/COIL20-0.0731682339406815-4.0.tree,OLD
96,31,35,234,396,148,COIL20_old/12/COIL20-0.018415131995677958-52.0.tree,OLD
95,32,34,223,384,145,COIL20_old/12/COIL20-0.019781571372680995-49.0.tree,OLD
604,260,231,1391,2486,758,COIL20_old/12/COIL20-0.010364851143900844-83.0.tree,OLD
391,165,149,916,1621,586,COIL20_old/12/COIL20-0.01365209777181664-69.0.tree,OLD
405,170,150,942,1667,594,COIL20_old/12/COIL20-0.012500500689320793-73.0.tree,OLD
394,164,149,923,1630,587,COIL20_old/12/COIL20-0.01252524405693306-72.0.tree,OLD
75,15,19,129,238,102,COIL20_old/12/COIL20-0.029527663667189563-22.0.tree,OLD
153,44,42,201,440,104,COIL20_old/12/COIL20-0.04277180443773787-10.0.tree,OLD
387,162,147,905,1601,579,COIL20_old/12/COIL20-0.013922970694538295-65.0.tree,OLD
335,114,118,633,1200,358,COIL20_old/12/COIL20-0.06573645577166709-5.0.tree,OLD
604,260,231,1393,2488,758,COIL20_old/12/COIL20-0.010174693997317574-85.0.tree,OLD
94,35,35,228,392,146,COIL20_old/12/COIL20-0.020113912642521214-48.0.tree,OLD
192,50,68,317,627,188,COIL20_old/12/COIL20-0.053958077166703755-7.0.tree,OLD
394,164,149,921,1628,585,COIL20_old/12/COIL20-0.013251196996795223-70.0.tree,OLD
97,31,35,236,399,150,COIL20_old/12/COIL20-0.018300066603324117-53.0.tree,OLD
394,164,149,922,1629,586,COIL20_old/12/COIL20-0.013005370184065723-71.0.tree,OLD
74,51,60,216,401,88,COIL20_old/12/COIL20-0.12086333976078723-1.0.tree,OLD
91,34,34,217,376,138,COIL20_old/12/COIL20-0.021333976078694306-45.0.tree,OLD
90,34,34,219,377,139,COIL20_old/12/COIL20-0.020305001304121773-47.0.tree,OLD
165,69,53,374,661,269,COIL20_old/12/COIL20-0.01494363169759283-60.0.tree,OLD
571,242,217,1311,2341,739,COIL20_old/12/COIL20-0.01042975445264177-82.0.tree,OLD
108,44,35,174,361,105,COIL20_old/12/COIL20-0.03563734257396284-14.0.tree,OLD
105,36,32,154,327,89,COIL20_old/12/COIL20-0.038626981798196625-12.0.tree,OLD
110,29,26,149,314,90,COIL20_old/12/COIL20-0.03538320198971656-15.0.tree,OLD
99,29,26,144,298,91,COIL20_old/12/COIL20-0.03354549752217029-16.0.tree,OLD
73,16,20,131,240,102,COIL20_old/12/COIL20-0.027202183005439917-23.0.tree,OLD
174,72,53,381,680,275,COIL20_old/12/COIL20-0.014941966614501367-61.0.tree,OLD
177,73,54,392,696,286,COIL20_old/12/COIL20-0.014329460559654783-63.0.tree,OLD
98,35,32,244,409,160,COIL20_old/12/COIL20-0.016782267680154894-57.0.tree,OLD
92,37,30,210,369,133,COIL20_old/12/COIL20-0.02310285323049488-43.0.tree,OLD
68,4,7,91,170,53,COIL20_old/12/COIL20-0.029723852373500337-20.0.tree,OLD
90,34,34,218,376,139,COIL20_old/12/COIL20-0.020415490628959143-46.0.tree,OLD
604,260,231,1392,2487,758,COIL20_old/12/COIL20-0.010289200480662286-84.0.tree,OLD
34,1,7,69,111,47,COIL20_old/12/COIL20-0.025562798084805327-29.0.tree,OLD
391,165,149,915,1620,585,COIL20_old/12/COIL20-0.013873355875996474-68.0.tree,OLD
591,240,214,1311,2356,734,COIL20_old/12/COIL20-0.010686677937997935-80.0.tree,OLD
188,49,68,314,619,186,COIL20_old/12/COIL20-0.04965041405842513-8.0.tree,OLD
424,177,157,979,1737,611,COIL20_old/12/COIL20-0.012265234928086621-74.0.tree,OLD
34,1,7,68,110,46,COIL20_old/12/COIL20-0.026596570161710686-28.0.tree,OLD
365,153,197,931,1646,506,COIL20_old/2/COIL20-0.033077329719055526-7.0.tree,OLD
73,20,21,186,300,147,COIL20_old/2/COIL20-0.01558697089947092-65.0.tree,OLD
456,175,217,1116,1964,640,COIL20_old/2/COIL20-0.027243390900961784-13.0.tree,OLD
46,11,10,116,183,76,COIL20_old/2/COIL20-0.02253627086593557-42.0.tree,OLD
77,24,32,203,336,152,COIL20_old/2/COIL20-0.020061282044116835-48.0.tree,OLD
436,165,203,1050,1854,615,COIL20_old/2/COIL20-0.025537577315746685-20.0.tree,OLD
74,24,29,196,323,146,COIL20_old/2/COIL20-0.019544081619344567-51.0.tree,OLD
139,42,51,354,586,271,COIL20_old/2/COIL20-0.012338358856844756-76.0.tree,OLD
74,24,30,195,323,147,COIL20_old/2/COIL20-0.019972834693345543-49.0.tree,OLD
75,24,30,199,328,149,COIL20_old/2/COIL20-0.01665919125866322-57.0.tree,OLD
437,169,200,1049,1855,617,COIL20_old/2/COIL20-0.024516485486996475-25.0.tree,OLD
436,168,199,1043,1846,615,COIL20_old/2/COIL20-0.02475205399061109-23.0.tree,OLD
485,176,231,1180,2072,658,COIL20_old/2/COIL20-0.023372654910946755-27.0.tree,OLD
505,216,187,1071,1979,549,COIL20_old/2/COIL20-0.08473564768239128-2.0.tree,OLD
75,24,30,198,327,148,COIL20_old/2/COIL20-0.01747966968477499-56.0.tree,OLD
439,167,212,1057,1875,615,COIL20_old/2/COIL20-0.029365382107459537-11.0.tree,OLD
87,25,33,222,367,170,COIL20_old/2/COIL20-0.016006036217304787-60.0.tree,OLD
74,24,30,196,324,147,COIL20_old/2/COIL20-0.01969457951412157-50.0.tree,OLD
86,24,30,216,356,158,COIL20_old/2/COIL20-0.015837734741783238-61.0.tree,OLD
122,37,43,307,509,246,COIL20_old/2/COIL20-0.012627314814815493-75.0.tree,OLD
73,22,32,199,326,148,COIL20_old/2/COIL20-0.020083789775690808-47.0.tree,OLD
705,283,310,1688,2986,723,COIL20_old/2/COIL20-0.0420699893807287-5.0.tree,OLD
77,24,29,198,328,147,COIL20_old/2/COIL20-0.019540739809224383-52.0.tree,OLD
136,41,49,340,566,270,COIL20_old/2/COIL20-0.0111041363924278-80.0.tree,OLD
132,40,48,340,560,269,COIL20_old/2/COIL20-0.010459330054400473-85.0.tree,OLD
73,20,21,185,299,146,COIL20_old/2/COIL20-0.015605647775542686-64.0.tree,OLD
99,34,34,265,432,216,COIL20_old/2/COIL20-0.014035893602354632-70.0.tree,OLD
546,212,235,1299,2292,718,COIL20_old/2/COIL20-0.02695472604143412-15.0.tree,OLD
436,168,199,1044,1847,615,COIL20_old/2/COIL20-0.024598866346225323-24.0.tree,OLD
608,233,306,1491,2638,733,COIL20_old/2/COIL20-0.03660901753111234-6.0.tree,OLD
363,152,195,921,1631,504,COIL20_old/2/COIL20-0.032168240927043845-8.0.tree,OLD
74,24,29,194,321,144,COIL20_old/2/COIL20-0.01846332625381869-53.0.tree,OLD
70,20,20,176,286,136,COIL20_old/2/COIL20-0.01566498528206256-62.0.tree,OLD
56,14,19,136,225,94,COIL20_old/2/COIL20-0.021560963000223865-43.0.tree,OLD
133,38,45,323,539,256,COIL20_old/2/COIL20-0.011989366756091469-77.0.tree,OLD
132,40,48,339,559,268,COIL20_old/2/COIL20-0.010599651147625566-84.0.tree,OLD
75,24,30,200,329,150,COIL20_old/2/COIL20-0.01636039617333629-58.0.tree,OLD
475,181,202,1098,1956,620,COIL20_old/2/COIL20-0.03015944043893004-10.0.tree,OLD
56,14,19,137,226,95,COIL20_old/2/COIL20-0.021083084153066367-44.0.tree,OLD
765,297,333,1739,3134,737,COIL20_old/2/COIL20-0.05555273772263264-3.0.tree,OLD
132,40,48,337,557,267,COIL20_old/2/COIL20-0.010991446363365187-82.0.tree,OLD
45,12,10,109,176,72,COIL20_old/2/COIL20-0.023039906103286045-39.0.tree,OLD
424,159,197,1013,1793,603,COIL20_old/2/COIL20-0.028366274033087946-12.0.tree,OLD
99,35,36,269,439,215,COIL20_old/2/COIL20-0.013799777833668647-72.0.tree,OLD
56,14,19,138,227,96,COIL20_old/2/COIL20-0.02021507517326121-45.0.tree,OLD
108,34,37,278,457,221,COIL20_old/2/COIL20-0.014210738970862336-69.0.tree,OLD
108,34,37,277,456,221,COIL20_old/2/COIL20-0.014251702343691552-68.0.tree,OLD
436,165,203,1049,1853,614,COIL20_old/2/COIL20-0.025648905004098554-19.0.tree,OLD
46,11,10,115,182,75,COIL20_old/2/COIL20-0.022854616122662152-41.0.tree,OLD
133,38,45,324,540,257,COIL20_old/2/COIL20-0.01181905087935059-78.0.tree,OLD
46,11,10,114,181,74,COIL20_old/2/COIL20-0.02300465990386774-40.0.tree,OLD
73,22,32,198,325,147,COIL20_old/2/COIL20-0.020119303785677223-46.0.tree,OLD
562,215,242,1294,2313,707,COIL20_old/2/COIL20-0.025076314367687536-21.0.tree,OLD
104,34,36,278,452,223,COIL20_old/2/COIL20-0.013181577893285668-73.0.tree,OLD
490,179,232,1192,2093,657,COIL20_old/2/COIL20-0.023544426279902664-26.0.tree,OLD
121,37,43,304,505,242,COIL20_old/2/COIL20-0.012967073272970309-74.0.tree,OLD
75,24,29,195,323,145,COIL20_old/2/COIL20-0.0184215361614124-54.0.tree,OLD
75,24,30,197,326,147,COIL20_old/2/COIL20-0.017739399359118502-55.0.tree,OLD
109,34,37,276,456,219,COIL20_old/2/COIL20-0.01501948030777328-67.0.tree,OLD
132,40,48,338,558,267,COIL20_old/2/COIL20-0.010792661058945718-83.0.tree,OLD
274,140,129,653,1196,276,COIL20_old/2/COIL20-0.1316015188352339-1.0.tree,OLD
136,41,49,341,567,271,COIL20_old/2/COIL20-0.011084749236157099-81.0.tree,OLD
136,41,48,338,563,268,COIL20_old/2/COIL20-0.011655535062225164-79.0.tree,OLD
99,34,36,268,437,216,COIL20_old/2/COIL20-0.013890332737163391-71.0.tree,OLD
446,215,220,1143,2024,643,COIL20_old/2/COIL20-0.04680716241895877-4.0.tree,OLD
132,40,49,345,566,272,COIL20_old/2/COIL20-0.010150497894776345-86.0.tree,OLD
73,20,21,187,301,147,COIL20_old/2/COIL20-0.015548254806617257-66.0.tree,OLD
436,168,199,1042,1845,615,COIL20_old/2/COIL20-0.024973393602354788-22.0.tree,OLD
376,141,170,881,1568,527,COIL20_old/2/COIL20-0.031729066528803196-9.0.tree,OLD
81,24,33,215,353,164,COIL20_old/2/COIL20-0.016347471402488156-59.0.tree,OLD
540,196,232,1242,2210,692,COIL20_old/2/COIL20-0.025966563268498943-17.0.tree,OLD
70,20,20,177,287,137,COIL20_old/2/COIL20-0.015659419479841508-63.0.tree,OLD
970,350,387,2120,3827,825,COIL20_old/13/COIL20-0.04948757358968653-5.0.tree,OLD
239,61,74,490,864,349,COIL20_old/13/COIL20-0.016192106341753443-60.0.tree,OLD
845,283,339,1856,3323,814,COIL20_old/13/COIL20-0.02801320655413908-21.0.tree,OLD
233,64,75,487,859,349,COIL20_old/13/COIL20-0.01697414812951792-58.0.tree,OLD
255,68,86,530,939,359,COIL20_old/13/COIL20-0.013157137268053176-69.0.tree,OLD
224,63,73,473,833,339,COIL20_old/13/COIL20-0.013930015276845786-66.0.tree,OLD
93,22,27,203,345,170,COIL20_old/13/COIL20-0.022491697872419947-42.0.tree,OLD
115,23,36,258,432,183,COIL20_old/13/COIL20-0.01871205240703583-53.0.tree,OLD
115,23,36,251,425,183,COIL20_old/13/COIL20-0.020546962329532126-48.0.tree,OLD
115,23,36,257,431,182,COIL20_old/13/COIL20-0.018783930434457752-52.0.tree,OLD
280,75,98,593,1046,400,COIL20_old/13/COIL20-0.01271276967359708-74.0.tree,OLD
1815,649,701,3814,6979,976,COIL20_old/13/COIL20-0.03125105959833052-14.0.tree,OLD
105,22,34,230,391,170,COIL20_old/13/COIL20-0.020730552295252558-46.0.tree,OLD
231,66,73,481,851,344,COIL20_old/13/COIL20-0.01570016161785609-62.0.tree,OLD
227,61,73,480,841,343,COIL20_old/13/COIL20-0.016701319025262562-59.0.tree,OLD
279,75,98,592,1044,404,COIL20_old/13/COIL20-0.012005237443177386-78.0.tree,OLD
244,69,76,502,891,351,COIL20_old/13/COIL20-0.01529604711602961-63.0.tree,OLD
848,304,400,1992,3544,802,COIL20_old/13/COIL20-0.05269104208584968-4.0.tree,OLD
156,46,56,341,599,254,COIL20_old/13/COIL20-0.027000463428720645-26.0.tree,OLD
820,284,329,1816,3249,804,COIL20_old/13/COIL20-0.027761092015052946-22.0.tree,OLD
343,133,140,758,1374,451,COIL20_old/13/COIL20-0.08665821316789685-2.0.tree,OLD
235,69,74,492,870,351,COIL20_old/13/COIL20-0.014753404687383898-65.0.tree,OLD
256,72,98,571,997,403,COIL20_old/13/COIL20-0.010907994261867393-82.0.tree,OLD
88,20,27,194,329,163,COIL20_old/13/COIL20-0.02440175776883513-36.0.tree,OLD
115,23,36,262,436,186,COIL20_old/13/COIL20-0.017492908841940602-57.0.tree,OLD
1144,383,432,2359,4318,846,COIL20_old/13/COIL20-0.0353376392614953-8.0.tree,OLD
92,22,27,199,340,168,COIL20_old/13/COIL20-0.02382412530740019-39.0.tree,OLD
1356,518,531,2915,5320,920,COIL20_old/13/COIL20-0.03793079076309713-7.0.tree,OLD
134,45,55,323,557,251,COIL20_old/13/COIL20-0.025224588270361947-29.0.tree,OLD
115,23,36,259,433,183,COIL20_old/13/COIL20-0.018517796594381186-54.0.tree,OLD
235,69,74,492,870,352,COIL20_old/13/COIL20-0.015129923056859618-64.0.tree,OLD
256,68,86,533,943,362,COIL20_old/13/COIL20-0.012867308014755718-72.0.tree,OLD
279,75,98,591,1043,403,COIL20_old/13/COIL20-0.01219411375661339-77.0.tree,OLD
256,68,86,531,941,360,COIL20_old/13/COIL20-0.013123090394217163-70.0.tree,OLD
115,23,36,260,434,184,COIL20_old/13/COIL20-0.017921312597809602-55.0.tree,OLD
242,68,83,510,903,360,COIL20_old/13/COIL20-0.01370950238467844-67.0.tree,OLD
1032,351,397,2192,3972,864,COIL20_old/13/COIL20-0.029482997522169707-16.0.tree,OLD
747,246,353,1698,3044,752,COIL20_old/13/COIL20-0.0662268402079137-3.0.tree,OLD
242,68,83,511,904,361,COIL20_old/13/COIL20-0.013581360850286162-68.0.tree,OLD
1800,655,723,3967,7145,992,COIL20_old/13/COIL20-0.04559375931515025-6.0.tree,OLD
156,46,56,342,600,255,COIL20_old/13/COIL20-0.026134398986512264-27.0.tree,OLD
115,23,36,252,426,184,COIL20_old/13/COIL20-0.02020601618973117-49.0.tree,OLD
1786,631,686,3723,6826,983,COIL20_old/13/COIL20-0.032932467490125794-11.0.tree,OLD
279,75,98,590,1042,403,COIL20_old/13/COIL20-0.012368458435799812-76.0.tree,OLD
1815,649,701,3813,6978,976,COIL20_old/13/COIL20-0.03162231490796624-13.0.tree,OLD
101,21,32,223,377,163,COIL20_old/13/COIL20-0.0212031680825695-44.0.tree,OLD
105,22,34,231,392,171,COIL20_old/13/COIL20-0.020676768947014923-47.0.tree,OLD
931,301,368,2019,3619,843,COIL20_old/13/COIL20-0.028201360943438003-19.0.tree,OLD
1767,622,682,3680,6751,982,COIL20_old/13/COIL20-0.03325084767866371-10.0.tree,OLD
76,30,49,219,374,103,COIL20_old/13/COIL20-0.1398885442283329-1.0.tree,OLD
1149,381,431,2361,4322,847,COIL20_old/13/COIL20-0.03460511914077041-9.0.tree,OLD
279,75,98,589,1041,401,COIL20_old/13/COIL20-0.012491138963410309-75.0.tree,OLD
92,22,27,200,341,168,COIL20_old/13/COIL20-0.0228791033236454-40.0.tree,OLD
802,272,320,1776,3170,805,COIL20_old/13/COIL20-0.02729131734853457-23.0.tree,OLD
256,73,95,566,990,403,COIL20_old/13/COIL20-0.011427325527237076-79.0.tree,OLD
256,68,86,534,944,363,COIL20_old/13/COIL20-0.012737012351889399-73.0.tree,OLD
256,72,95,566,989,403,COIL20_old/13/COIL20-0.011255461006780432-80.0.tree,OLD
88,20,27,195,330,164,COIL20_old/13/COIL20-0.024291361595498828-37.0.tree,OLD
91,21,27,197,336,166,COIL20_old/13/COIL20-0.024262205175497542-38.0.tree,OLD
115,23,36,253,427,185,COIL20_old/13/COIL20-0.020040975016767493-50.0.tree,OLD
256,72,95,567,990,403,COIL20_old/13/COIL20-0.011112950853268189-81.0.tree,OLD
115,23,36,256,430,181,COIL20_old/13/COIL20-0.019503106602578812-51.0.tree,OLD
256,68,86,532,942,361,COIL20_old/13/COIL20-0.012931652414487405-71.0.tree,OLD
1761,622,670,3665,6718,973,COIL20_old/13/COIL20-0.03225679307325402-12.0.tree,OLD
99,21,32,221,373,160,COIL20_old/13/COIL20-0.021719122606007057-43.0.tree,OLD
101,21,32,224,378,163,COIL20_old/13/COIL20-0.020901485300693023-45.0.tree,OLD
157,46,56,344,603,257,COIL20_old/13/COIL20-0.026122359154929886-28.0.tree,OLD
115,23,36,261,435,185,COIL20_old/13/COIL20-0.0178743409531269-56.0.tree,OLD
236,64,74,486,860,346,COIL20_old/13/COIL20-0.015839003930992857-61.0.tree,OLD
841,326,386,1996,3549,826,COIL20_old/5/COIL20-0.03165813166033227-7.0.tree,OLD
637,236,246,1369,2488,730,COIL20_old/5/COIL20-0.011966160388254876-78.0.tree,OLD
591,204,257,1278,2330,667,COIL20_old/5/COIL20-0.03998912456218817-4.0.tree,OLD
545,203,201,1153,2102,650,COIL20_old/5/COIL20-0.013448736399880035-65.0.tree,OLD
276,92,106,595,1069,386,COIL20_old/5/COIL20-0.02016185073403387-47.0.tree,OLD
1210,473,524,2717,4924,917,COIL20_old/5/COIL20-0.033631872252030015-6.0.tree,OLD
601,229,226,1289,2345,705,COIL20_old/5/COIL20-0.01251304121022373-75.0.tree,OLD
610,215,303,1464,2592,721,COIL20_old/5/COIL20-0.02395006613756695-26.0.tree,OLD
248,81,98,531,958,345,COIL20_old/5/COIL20-0.022551734015203162-40.0.tree,OLD
607,228,230,1295,2360,705,COIL20_old/5/COIL20-0.01246435790669953-76.0.tree,OLD
733,256,329,1673,2991,765,COIL20_old/5/COIL20-0.030228582140993998-8.0.tree,OLD
536,198,202,1144,2080,650,COIL20_old/5/COIL20-0.013072474197034223-67.0.tree,OLD
607,216,301,1457,2581,725,COIL20_old/5/COIL20-0.024557798177956447-22.0.tree,OLD
348,111,130,731,1320,451,COIL20_old/5/COIL20-0.019911925255234608-49.0.tree,OLD
745,257,332,1691,3025,768,COIL20_old/5/COIL20-0.029737254545793568-10.0.tree,OLD
460,190,196,1063,1909,624,COIL20_old/5/COIL20-0.022914070068559833-39.0.tree,OLD
254,84,101,553,992,360,COIL20_old/5/COIL20-0.021181976115955126-43.0.tree,OLD
617,218,306,1479,2620,726,COIL20_old/5/COIL20-0.024364101274311933-23.0.tree,OLD
513,187,183,1057,1940,608,COIL20_old/5/COIL20-0.01793237433862377-52.0.tree,OLD
373,126,216,965,1680,554,COIL20_old/5/COIL20-0.03586307195021937-5.0.tree,OLD
613,216,303,1467,2599,721,COIL20_old/5/COIL20-0.023977906792607473-25.0.tree,OLD
568,216,208,1193,2185,669,COIL20_old/5/COIL20-0.013033536869364426-68.0.tree,OLD
623,236,240,1339,2438,715,COIL20_old/5/COIL20-0.011630081414411908-83.0.tree,OLD
622,235,240,1333,2430,715,COIL20_old/5/COIL20-0.011900115973619563-79.0.tree,OLD
614,228,232,1307,2381,708,COIL20_old/5/COIL20-0.01225517456591374-77.0.tree,OLD
761,263,341,1725,3090,772,COIL20_old/5/COIL20-0.02982764643416097-9.0.tree,OLD
429,148,214,1009,1800,505,COIL20_old/5/COIL20-0.052252927285937-3.0.tree,OLD
513,187,183,1055,1938,607,COIL20_old/5/COIL20-0.01920622112303544-50.0.tree,OLD
544,203,201,1150,2098,648,COIL20_old/5/COIL20-0.013715196270213559-63.0.tree,OLD
513,187,183,1059,1942,609,COIL20_old/5/COIL20-0.017312602466651117-54.0.tree,OLD
617,218,306,1480,2621,726,COIL20_old/5/COIL20-0.02423551727028883-24.0.tree,OLD
348,111,130,730,1319,451,COIL20_old/5/COIL20-0.02015503903047916-48.0.tree,OLD
624,237,240,1340,2441,719,COIL20_old/5/COIL20-0.011677297581786872-82.0.tree,OLD
622,235,240,1334,2431,716,COIL20_old/5/COIL20-0.011776061461360121-80.0.tree,OLD
601,211,298,1439,2549,721,COIL20_old/5/COIL20-0.02475290399806168-21.0.tree,OLD
588,222,217,1239,2266,688,COIL20_old/5/COIL20-0.012907852205826909-71.0.tree,OLD
588,222,217,1240,2267,688,COIL20_old/5/COIL20-0.012876285490721118-72.0.tree,OLD
534,185,269,1298,2286,676,COIL20_old/5/COIL20-0.027273350752663517-15.0.tree,OLD
536,202,200,1138,2076,642,COIL20_old/5/COIL20-0.015191379760041923-59.0.tree,OLD
254,84,101,551,990,357,COIL20_old/5/COIL20-0.02234901305983983-41.0.tree,OLD
538,203,201,1144,2086,639,COIL20_old/5/COIL20-0.015501865358819478-58.0.tree,OLD
513,187,183,1056,1939,608,COIL20_old/5/COIL20-0.018707685930397677-51.0.tree,OLD
203,94,151,536,984,316,COIL20_old/5/COIL20-0.07699701682316018-2.0.tree,OLD
601,229,226,1288,2344,704,COIL20_old/5/COIL20-0.01261338866532552-74.0.tree,OLD
513,187,183,1060,1943,610,COIL20_old/5/COIL20-0.01694117249795135-55.0.tree,OLD
538,202,200,1140,2080,644,COIL20_old/5/COIL20-0.01446610216856642-61.0.tree,OLD
574,202,284,1376,2436,703,COIL20_old/5/COIL20-0.02676782919740711-16.0.tree,OLD
264,87,100,562,1013,363,COIL20_old/5/COIL20-0.020698857496832312-44.0.tree,OLD
513,187,183,1058,1941,608,COIL20_old/5/COIL20-0.017557835438557712-53.0.tree,OLD
276,92,106,593,1067,386,COIL20_old/5/COIL20-0.020677397719650603-45.0.tree,OLD
538,202,200,1139,2079,644,COIL20_old/5/COIL20-0.014883490759371787-60.0.tree,OLD
567,190,269,1340,2366,686,COIL20_old/5/COIL20-0.028607198748044738-12.0.tree,OLD
254,84,101,552,991,358,COIL20_old/5/COIL20-0.022012957373871933-42.0.tree,OLD
544,203,201,1149,2097,648,COIL20_old/5/COIL20-0.01414569593486853-62.0.tree,OLD
588,222,217,1241,2268,689,COIL20_old/5/COIL20-0.012616707187570297-73.0.tree,OLD
276,92,106,594,1068,386,COIL20_old/5/COIL20-0.020666335978836214-46.0.tree,OLD
590,223,219,1245,2277,689,COIL20_old/5/COIL20-0.01302969436992324-69.0.tree,OLD
542,201,200,1146,2089,652,COIL20_old/5/COIL20-0.013348307437215878-66.0.tree,OLD
527,178,241,1208,2154,665,COIL20_old/5/COIL20-0.025025162549369928-17.0.tree,OLD
134,44,100,342,620,193,COIL20_old/5/COIL20-0.13384304670616298-1.0.tree,OLD
587,222,217,1237,2263,688,COIL20_old/5/COIL20-0.012953251918919828-70.0.tree,OLD
545,203,201,1152,2101,648,COIL20_old/5/COIL20-0.013623500260822874-64.0.tree,OLD
570,191,271,1349,2381,687,COIL20_old/5/COIL20-0.02829702753558444-13.0.tree,OLD
745,257,332,1692,3026,768,COIL20_old/5/COIL20-0.029367466372308415-11.0.tree,OLD
530,198,197,1123,2048,631,COIL20_old/5/COIL20-0.015503984555481187-57.0.tree,OLD
508,185,180,1048,1921,603,COIL20_old/5/COIL20-0.01633505896490095-56.0.tree,OLD
621,235,240,1334,2430,717,COIL20_old/5/COIL20-0.011748581768387834-81.0.tree,OLD
464,200,224,1164,2052,611,COIL20_old/14/COIL20-0.053102468980549045-8.0.tree,OLD
296,95,90,599,1080,423,COIL20_old/14/COIL20-0.014091737927565628-65.0.tree,OLD
275,95,82,547,999,384,COIL20_old/14/COIL20-0.018614103603100063-51.0.tree,OLD
489,216,205,1094,2004,609,COIL20_old/14/COIL20-0.03766464527908242-13.0.tree,OLD
328,103,98,647,1176,453,COIL20_old/14/COIL20-0.013829155488486289-67.0.tree,OLD
281,96,84,557,1018,389,COIL20_old/14/COIL20-0.01803655264922943-53.0.tree,OLD
228,70,70,457,825,364,COIL20_old/14/COIL20-0.020760267624265083-43.0.tree,OLD
481,200,217,1099,1997,621,COIL20_old/14/COIL20-0.03356114697444057-16.0.tree,OLD
91,50,42,270,453,186,COIL20_old/14/COIL20-0.027437437122736053-25.0.tree,OLD
494,211,209,1088,2002,628,COIL20_old/14/COIL20-0.036658236455771154-14.0.tree,OLD
302,99,90,605,1096,411,COIL20_old/14/COIL20-0.014491171566435368-63.0.tree,OLD
68,39,25,186,318,115,COIL20_old/14/COIL20-0.029336155823831866-22.0.tree,OLD
270,123,119,606,1118,414,COIL20_old/14/COIL20-0.1161210783217822-2.0.tree,OLD
296,101,88,591,1076,416,COIL20_old/14/COIL20-0.014952585885685044-61.0.tree,OLD
171,60,79,388,698,251,COIL20_old/14/COIL20-0.14211143015500421-1.0.tree,OLD
291,99,87,577,1054,407,COIL20_old/14/COIL20-0.017327576570534742-56.0.tree,OLD
490,209,223,1128,2050,632,COIL20_old/14/COIL20-0.029688710969521137-20.0.tree,OLD
48,23,35,127,233,81,COIL20_old/14/COIL20-0.08108833556896883-4.0.tree,OLD
465,143,130,900,1638,599,COIL20_old/14/COIL20-0.011299067553468212-83.0.tree,OLD
470,151,132,914,1667,604,COIL20_old/14/COIL20-0.010726826235189502-84.0.tree,OLD
329,104,98,648,1179,454,COIL20_old/14/COIL20-0.014089013246143922-66.0.tree,OLD
333,104,98,655,1190,457,COIL20_old/14/COIL20-0.01335506092108224-71.0.tree,OLD
340,108,100,677,1225,473,COIL20_old/14/COIL20-0.013180378567701934-73.0.tree,OLD
275,95,84,552,1006,389,COIL20_old/14/COIL20-0.01912583137715146-49.0.tree,OLD
333,104,98,653,1188,456,COIL20_old/14/COIL20-0.013403860663984246-70.0.tree,OLD
461,142,129,892,1624,596,COIL20_old/14/COIL20-0.011751667411878441-80.0.tree,OLD
299,101,89,592,1081,413,COIL20_old/14/COIL20-0.015478041862284686-59.0.tree,OLD
47,20,29,106,202,76,COIL20_old/14/COIL20-0.06611484881511392-6.0.tree,OLD
410,171,193,955,1729,576,COIL20_old/14/COIL20-0.05000086165139034-9.0.tree,OLD
228,71,70,459,828,365,COIL20_old/14/COIL20-0.020651652973394774-44.0.tree,OLD
493,209,222,1125,2049,636,COIL20_old/14/COIL20-0.03308144002906288-17.0.tree,OLD
381,172,188,937,1678,542,COIL20_old/14/COIL20-0.05675086398017731-7.0.tree,OLD
298,100,89,599,1086,412,COIL20_old/14/COIL20-0.014529468477531615-62.0.tree,OLD
428,141,119,834,1522,554,COIL20_old/14/COIL20-0.012556077203963734-76.0.tree,OLD
494,210,224,1134,2062,636,COIL20_old/14/COIL20-0.030608640267529963-19.0.tree,OLD
281,96,84,558,1019,390,COIL20_old/14/COIL20-0.01784013106416349-54.0.tree,OLD
433,185,208,1033,1859,592,COIL20_old/14/COIL20-0.04714622224085252-10.0.tree,OLD
470,151,133,920,1674,608,COIL20_old/14/COIL20-0.010487217285192363-86.0.tree,OLD
233,72,71,465,841,367,COIL20_old/14/COIL20-0.01917111465086696-48.0.tree,OLD
340,108,100,675,1223,472,COIL20_old/14/COIL20-0.013304468011773596-72.0.tree,OLD
211,70,67,443,791,353,COIL20_old/14/COIL20-0.021806358987257024-41.0.tree,OLD
171,49,56,358,634,297,COIL20_old/14/COIL20-0.024071395968402742-39.0.tree,OLD
486,160,140,959,1745,606,COIL20_old/14/COIL20-0.012282654258886305-77.0.tree,OLD
281,96,84,559,1020,390,COIL20_old/14/COIL20-0.017451957113048977-55.0.tree,OLD
330,103,98,650,1181,454,COIL20_old/14/COIL20-0.013457096747149733-69.0.tree,OLD
293,101,88,586,1068,398,COIL20_old/14/COIL20-0.016344409046874064-58.0.tree,OLD
291,99,87,578,1055,407,COIL20_old/14/COIL20-0.017174505365526616-57.0.tree,OLD
422,140,119,824,1505,549,COIL20_old/14/COIL20-0.013179994317757848-74.0.tree,OLD
228,71,70,460,829,366,COIL20_old/14/COIL20-0.020562472054549308-45.0.tree,OLD
68,39,25,187,319,116,COIL20_old/14/COIL20-0.028915961044041538-23.0.tree,OLD
211,70,67,444,792,354,COIL20_old/14/COIL20-0.02105368321037243-42.0.tree,OLD
428,141,119,833,1521,554,COIL20_old/14/COIL20-0.0128857287241963-75.0.tree,OLD
299,101,89,593,1082,413,COIL20_old/14/COIL20-0.015404580259333833-60.0.tree,OLD
282,96,84,556,1018,390,COIL20_old/14/COIL20-0.018595321931589137-52.0.tree,OLD
214,68,67,441,790,355,COIL20_old/14/COIL20-0.022798387547507626-40.0.tree,OLD
95,50,42,276,463,192,COIL20_old/14/COIL20-0.024694498006557042-28.0.tree,OLD
493,209,222,1126,2050,634,COIL20_old/14/COIL20-0.032242995007079445-18.0.tree,OLD
461,142,129,893,1625,597,COIL20_old/14/COIL20-0.011625039589387876-81.0.tree,OLD
494,211,209,1089,2003,628,COIL20_old/14/COIL20-0.03605905106565288-15.0.tree,OLD
92,50,42,272,456,188,COIL20_old/14/COIL20-0.026579465217229148-26.0.tree,OLD
490,161,140,962,1753,606,COIL20_old/14/COIL20-0.01226795960950916-78.0.tree,OLD
227,70,69,457,823,363,COIL20_old/14/COIL20-0.019841782174528866-47.0.tree,OLD
193,85,81,405,764,302,COIL20_old/14/COIL20-0.09529034158655658-3.0.tree,OLD
80,46,31,221,378,142,COIL20_old/14/COIL20-0.028163646229227235-24.0.tree,OLD
470,151,132,915,1668,604,COIL20_old/14/COIL20-0.010638996013114799-85.0.tree,OLD
91,50,42,272,455,189,COIL20_old/14/COIL20-0.02603794060660347-27.0.tree,OLD
330,103,98,649,1180,453,COIL20_old/14/COIL20-0.013825650663238376-68.0.tree,OLD
426,187,196,993,1802,552,COIL20_old/14/COIL20-0.04062589658320298-12.0.tree,OLD
275,95,82,546,998,384,COIL20_old/14/COIL20-0.018697474197035213-50.0.tree,OLD
461,143,130,893,1627,597,COIL20_old/14/COIL20-0.012022377319471866-79.0.tree,OLD
419,185,194,985,1783,543,COIL20_old/14/COIL20-0.04337187476712073-11.0.tree,OLD
464,142,129,897,1632,597,COIL20_old/14/COIL20-0.011488258253222583-82.0.tree,OLD
49,16,35,120,220,71,COIL20_old/14/COIL20-0.07436856090245197-5.0.tree,OLD
226,68,70,458,822,368,COIL20_old/14/COIL20-0.020236406867128576-46.0.tree,OLD
312,102,93,625,1132,423,COIL20_old/14/COIL20-0.014218691780312154-64.0.tree,OLD
470,151,133,921,1675,609,COIL20_old/14/COIL20-0.010397267866458504-87.0.tree,OLD
201,73,68,389,731,230,COIL20_old/22/COIL20-0.027761697499813276-21.0.tree,OLD
380,106,139,778,1403,465,COIL20_old/22/COIL20-0.01624436433415344-62.0.tree,OLD
410,169,181,949,1709,533,COIL20_old/22/COIL20-0.0579710438557271-6.0.tree,OLD
327,92,121,672,1212,400,COIL20_old/22/COIL20-0.017864327166703775-50.0.tree,OLD
986,354,368,2136,3844,857,COIL20_old/22/COIL20-0.012657623984648425-77.0.tree,OLD
408,167,172,926,1673,526,COIL20_old/22/COIL20-0.054650507209926424-7.0.tree,OLD
360,103,133,740,1336,444,COIL20_old/22/COIL20-0.017107296557120122-54.0.tree,OLD
191,72,71,399,733,265,COIL20_old/22/COIL20-0.0266057455846197-22.0.tree,OLD
370,105,125,722,1322,444,COIL20_old/22/COIL20-0.01676445245547392-57.0.tree,OLD
1077,384,382,2309,4152,885,COIL20_old/22/COIL20-0.008080718104925666-110.0.tree,OLD
197,67,70,390,724,221,COIL20_old/22/COIL20-0.029003570031298276-19.0.tree,OLD
1051,371,380,2244,4046,873,COIL20_old/22/COIL20-0.011113730997093618-86.0.tree,OLD
1055,371,382,2251,4059,874,COIL20_old/22/COIL20-0.01009819332662576-93.0.tree,OLD
992,355,367,2140,3854,857,COIL20_old/22/COIL20-0.012461272263207868-78.0.tree,OLD
1055,371,382,2253,4061,875,COIL20_old/22/COIL20-0.009816060716148212-95.0.tree,OLD
123,29,51,266,469,169,COIL20_old/22/COIL20-0.024224408953722742-37.0.tree,OLD
143,56,44,268,511,162,COIL20_old/22/COIL20-0.04895770456069809-8.0.tree,OLD
143,51,40,252,486,149,COIL20_old/22/COIL20-0.04079862275504881-11.0.tree,OLD
1053,371,381,2247,4052,875,COIL20_old/22/COIL20-0.010711328154110022-89.0.tree,OLD
378,106,139,776,1399,464,COIL20_old/22/COIL20-0.016669845461658395-60.0.tree,OLD
1155,412,416,2493,4476,904,COIL20_old/22/COIL20-0.007995961882405422-111.0.tree,OLD
181,48,72,366,667,244,COIL20_old/22/COIL20-0.024220403439153493-38.0.tree,OLD
1077,384,382,2306,4149,885,COIL20_old/22/COIL20-0.008338223787167698-107.0.tree,OLD
1071,383,384,2297,4135,886,COIL20_old/22/COIL20-0.00874635544749941-103.0.tree,OLD
347,101,120,670,1238,422,COIL20_old/22/COIL20-0.021887738467844198-43.0.tree,OLD
1156,412,417,2496,4481,905,COIL20_old/22/COIL20-0.007735847958117548-113.0.tree,OLD
55,32,10,112,209,73,COIL20_old/22/COIL20-0.026168946549669003-25.0.tree,OLD
348,101,120,676,1245,426,COIL20_old/22/COIL20-0.02019664281988165-47.0.tree,OLD
1046,369,382,2238,4035,870,COIL20_old/22/COIL20-0.011625703293836831-83.0.tree,OLD
316,93,110,641,1160,393,COIL20_old/22/COIL20-0.01886180508979729-48.0.tree,OLD
360,103,133,741,1337,445,COIL20_old/22/COIL20-0.017088421734109793-55.0.tree,OLD
501,150,186,1040,1877,596,COIL20_old/22/COIL20-0.014540017885088075-71.0.tree,OLD
259,112,130,656,1157,347,COIL20_old/22/COIL20-0.1467948314889334-1.0.tree,OLD
404,110,148,821,1483,486,COIL20_old/22/COIL20-0.015382922535211507-66.0.tree,OLD
405,110,148,824,1487,487,COIL20_old/22/COIL20-0.01466387445040579-69.0.tree,OLD
360,103,133,742,1338,445,COIL20_old/22/COIL20-0.0170752524405709-56.0.tree,OLD
992,355,367,2142,3856,858,COIL20_old/22/COIL20-0.01220233437662982-80.0.tree,OLD
1071,383,384,2296,4134,885,COIL20_old/22/COIL20-0.008925404277517146-100.0.tree,OLD
113,38,36,224,411,139,COIL20_old/22/COIL20-0.04583877105223949-9.0.tree,OLD
1071,383,384,2297,4135,886,COIL20_old/22/COIL20-0.008856914635963775-101.0.tree,OLD
1053,371,381,2248,4053,873,COIL20_old/22/COIL20-0.01089499962739382-87.0.tree,OLD
188,60,56,350,654,242,COIL20_old/22/COIL20-0.04313911245249302-10.0.tree,OLD
329,95,120,677,1221,415,COIL20_old/22/COIL20-0.01836637882852654-49.0.tree,OLD
59,33,10,116,218,81,COIL20_old/22/COIL20-0.025820501713987365-26.0.tree,OLD
378,106,139,777,1400,465,COIL20_old/22/COIL20-0.01640952194649431-61.0.tree,OLD
61,34,12,131,238,95,COIL20_old/22/COIL20-0.024424556598852343-28.0.tree,OLD
1054,371,382,2249,4056,874,COIL20_old/22/COIL20-0.010167369960503547-92.0.tree,OLD
308,100,132,671,1211,449,COIL20_old/22/COIL20-0.02303250055890893-39.0.tree,OLD
405,110,148,825,1488,488,COIL20_old/22/COIL20-0.0145594632610484-70.0.tree,OLD
1054,371,382,2248,4055,874,COIL20_old/22/COIL20-0.010294160798122953-91.0.tree,OLD
1049,371,380,2243,4043,873,COIL20_old/22/COIL20-0.011120437905208669-85.0.tree,OLD
403,110,148,819,1480,485,COIL20_old/22/COIL20-0.01540419600938947-64.0.tree,OLD
163,65,60,367,655,193,COIL20_old/22/COIL20-0.06181685017512495-5.0.tree,OLD
1055,371,382,2252,4060,875,COIL20_old/22/COIL20-0.010073892428646036-94.0.tree,OLD
500,151,186,1045,1882,598,COIL20_old/22/COIL20-0.013859429726507666-73.0.tree,OLD
992,355,367,2143,3857,858,COIL20_old/22/COIL20-0.012097888255459321-81.0.tree,OLD
209,74,71,404,758,237,COIL20_old/22/COIL20-0.03267263302034423-17.0.tree,OLD
138,47,37,239,461,137,COIL20_old/22/COIL20-0.03889797116029625-12.0.tree,OLD
347,101,120,671,1239,423,COIL20_old/22/COIL20-0.0216825955734411-44.0.tree,OLD
1155,412,416,2494,4477,904,COIL20_old/22/COIL20-0.0077372685185172485-112.0.tree,OLD
201,73,68,388,730,230,COIL20_old/22/COIL20-0.028225999515612388-20.0.tree,OLD
358,102,132,734,1326,441,COIL20_old/22/COIL20-0.017360214527907813-53.0.tree,OLD
1144,408,417,2480,4449,902,COIL20_old/22/COIL20-0.0077121991206489104-114.0.tree,OLD
1053,371,381,2246,4051,874,COIL20_old/22/COIL20-0.010745957224830627-88.0.tree,OLD
1071,383,384,2295,4133,885,COIL20_old/22/COIL20-0.009166992696923004-99.0.tree,OLD
113,59,53,284,509,172,COIL20_old/22/COIL20-0.089950944090469-2.0.tree,OLD
499,151,186,1043,1879,599,COIL20_old/22/COIL20-0.013890693699232515-72.0.tree,OLD
1056,371,382,2253,4062,876,COIL20_old/22/COIL20-0.009739210727327141-96.0.tree,OLD
1072,384,381,2299,4136,886,COIL20_old/22/COIL20-0.008604823384752214-106.0.tree,OLD
136,71,57,352,616,223,COIL20_old/22/COIL20-0.06691141059318834-4.0.tree,OLD
137,71,55,349,612,220,COIL20_old/22/COIL20-0.07587324875176937-3.0.tree,OLD
209,74,71,405,759,238,COIL20_old/22/COIL20-0.03157802136895488-18.0.tree,OLD
348,101,120,675,1244,425,COIL20_old/22/COIL20-0.02043696205007761-46.0.tree,OLD
509,156,182,1049,1896,602,COIL20_old/22/COIL20-0.012731574632982134-76.0.tree,OLD
1077,384,382,2307,4150,885,COIL20_old/22/COIL20-0.008306633784186113-108.0.tree,OLD
203,74,67,397,741,229,COIL20_old/22/COIL20-0.03605448664207522-15.0.tree,OLD
404,110,148,820,1482,485,COIL20_old/22/COIL20-0.01539308769282366-65.0.tree,OLD
358,102,132,733,1325,441,COIL20_old/22/COIL20-0.017459595536179595-52.0.tree,OLD
1071,383,384,2298,4136,886,COIL20_old/22/COIL20-0.008671613011400958-104.0.tree,OLD
520,163,186,1076,1945,613,COIL20_old/22/COIL20-0.013686656978909972-75.0.tree,OLD
1046,369,382,2239,4036,870,COIL20_old/22/COIL20-0.011416310362172555-84.0.tree,OLD
1077,384,382,2308,4151,885,COIL20_old/22/COIL20-0.0081016539049103-109.0.tree,OLD
348,101,120,674,1243,425,COIL20_old/22/COIL20-0.02142744196661389-45.0.tree,OLD
1071,383,384,2298,4136,886,COIL20_old/22/COIL20-0.008792151054474562-102.0.tree,OLD
203,74,67,396,740,229,COIL20_old/22/COIL20-0.038160502366048066-14.0.tree,OLD
404,110,148,822,1484,486,COIL20_old/22/COIL20-0.014945343356434937-67.0.tree,OLD
1027,368,375,2216,3986,873,COIL20_old/22/COIL20-0.009660800450853047-97.0.tree,OLD
222,76,77,417,792,235,COIL20_old/22/COIL20-0.033542144068112456-16.0.tree,OLD
520,163,186,1075,1944,612,COIL20_old/22/COIL20-0.013846737834414147-74.0.tree,OLD
403,110,148,818,1479,484,COIL20_old/22/COIL20-0.015749205883449413-63.0.tree,OLD
370,105,134,754,1363,452,COIL20_old/22/COIL20-0.01668105857366403-59.0.tree,OLD
1054,371,382,2247,4054,874,COIL20_old/22/COIL20-0.01031487536329051-90.0.tree,OLD
347,101,120,669,1237,421,COIL20_old/22/COIL20-0.021889298755495834-42.0.tree,OLD
404,110,148,823,1485,486,COIL20_old/22/COIL20-0.014754138255458904-68.0.tree,OLD
358,102,132,732,1324,441,COIL20_old/22/COIL20-0.017775344194799703-51.0.tree,OLD
1024,361,376,2199,3960,864,COIL20_old/22/COIL20-0.01178833417169678-82.0.tree,OLD
1027,368,375,2217,3987,873,COIL20_old/22/COIL20-0.009508940215366968-98.0.tree,OLD
60,34,10,121,225,86,COIL20_old/22/COIL20-0.02566764009985789-27.0.tree,OLD
1078,384,384,2305,4151,886,COIL20_old/22/COIL20-0.008671368488710585-105.0.tree,OLD
992,355,367,2141,3855,857,COIL20_old/22/COIL20-0.012457138665324552-79.0.tree,OLD
697,291,264,1599,2851,773,COIL20_old/25/COIL20-0.014112825098740789-74.0.tree,OLD
818,334,297,1821,3270,815,COIL20_old/25/COIL20-0.01254761206125743-82.0.tree,OLD
289,133,130,703,1255,422,COIL20_old/25/COIL20-0.04803496907370125-4.0.tree,OLD
818,333,297,1821,3269,816,COIL20_old/25/COIL20-0.012343272598554222-83.0.tree,OLD
600,254,236,1411,2501,741,COIL20_old/25/COIL20-0.01518949344213466-69.0.tree,OLD
320,118,151,782,1371,483,COIL20_old/25/COIL20-0.02237460643490563-26.0.tree,OLD
549,236,213,1274,2272,710,COIL20_old/25/COIL20-0.01734709181011934-59.0.tree,OLD
320,118,151,784,1373,485,COIL20_old/25/COIL20-0.02192637305313322-28.0.tree,OLD
320,118,151,787,1376,486,COIL20_old/25/COIL20-0.02154902796408059-31.0.tree,OLD
685,288,262,1578,2813,773,COIL20_old/25/COIL20-0.015173552891422859-70.0.tree,OLD
320,118,151,786,1375,486,COIL20_old/25/COIL20-0.0215895139354646-30.0.tree,OLD
817,334,293,1815,3259,817,COIL20_old/25/COIL20-0.011804239790595472-86.0.tree,OLD
380,127,168,869,1544,525,COIL20_old/25/COIL20-0.02605778187644392-14.0.tree,OLD
515,224,204,1195,2138,696,COIL20_old/25/COIL20-0.020076104776808767-51.0.tree,OLD
532,232,208,1241,2213,708,COIL20_old/25/COIL20-0.018417216260526448-58.0.tree,OLD
727,305,272,1655,2959,788,COIL20_old/25/COIL20-0.012694360608093369-80.0.tree,OLD
113,75,96,438,722,208,COIL20_old/25/COIL20-0.1364244145428128-1.0.tree,OLD
562,236,217,1308,2323,707,COIL20_old/25/COIL20-0.015514825061479276-64.0.tree,OLD
320,120,170,818,1428,471,COIL20_old/25/COIL20-0.02460035677025152-18.0.tree,OLD
600,254,235,1409,2498,741,COIL20_old/25/COIL20-0.015221374543557764-68.0.tree,OLD
819,334,293,1820,3266,817,COIL20_old/25/COIL20-0.011594870146806602-87.0.tree,OLD
817,334,293,1814,3258,816,COIL20_old/25/COIL20-0.011946493777480527-85.0.tree,OLD
727,305,272,1653,2957,787,COIL20_old/25/COIL20-0.013053308275579378-78.0.tree,OLD
549,236,214,1276,2275,708,COIL20_old/25/COIL20-0.01674755710187159-60.0.tree,OLD
600,254,234,1405,2493,739,COIL20_old/25/COIL20-0.015464569826365293-65.0.tree,OLD
324,120,151,792,1387,491,COIL20_old/25/COIL20-0.021139662046351593-33.0.tree,OLD
63,24,41,157,285,100,COIL20_old/25/COIL20-0.08776826468067661-2.0.tree,OLD
320,120,170,819,1429,471,COIL20_old/25/COIL20-0.024344353155972775-19.0.tree,OLD
468,155,190,1018,1831,570,COIL20_old/25/COIL20-0.028098032640286874-10.0.tree,OLD
519,224,204,1200,2147,698,COIL20_old/25/COIL20-0.019451209572248163-53.0.tree,OLD
689,290,263,1586,2828,773,COIL20_old/25/COIL20-0.014468791918176682-72.0.tree,OLD
562,236,217,1306,2321,706,COIL20_old/25/COIL20-0.016210061293688682-62.0.tree,OLD
484,176,207,1116,1983,583,COIL20_old/25/COIL20-0.03466456144273039-6.0.tree,OLD
380,126,165,865,1536,520,COIL20_old/25/COIL20-0.027399361446456605-12.0.tree,OLD
721,305,271,1642,2939,782,COIL20_old/25/COIL20-0.013425401948728988-77.0.tree,OLD
321,131,144,751,1347,455,COIL20_old/25/COIL20-0.0652837976935689-3.0.tree,OLD
600,254,234,1406,2494,739,COIL20_old/25/COIL20-0.015457280721365096-66.0.tree,OLD
320,118,151,785,1374,486,COIL20_old/25/COIL20-0.021737170709441422-29.0.tree,OLD
532,233,208,1241,2214,708,COIL20_old/25/COIL20-0.018906552742380234-57.0.tree,OLD
839,335,300,1861,3335,821,COIL20_old/25/COIL20-0.010309251341382109-92.0.tree,OLD
819,334,293,1821,3267,817,COIL20_old/25/COIL20-0.011388586146508783-88.0.tree,OLD
600,254,234,1407,2495,739,COIL20_old/25/COIL20-0.01523057325434135-67.0.tree,OLD
325,120,171,832,1448,476,COIL20_old/25/COIL20-0.022734427397719026-21.0.tree,OLD
545,234,215,1280,2274,700,COIL20_old/25/COIL20-0.016226921715478293-61.0.tree,OLD
335,119,153,815,1422,494,COIL20_old/25/COIL20-0.020590277777778332-35.0.tree,OLD
461,151,190,1009,1811,570,COIL20_old/25/COIL20-0.027506462385423702-11.0.tree,OLD
839,335,300,1860,3334,821,COIL20_old/25/COIL20-0.010418296817944372-91.0.tree,OLD
515,224,204,1196,2139,696,COIL20_old/25/COIL20-0.0200043082569491-52.0.tree,OLD
727,305,272,1654,2958,787,COIL20_old/25/COIL20-0.01302740051419643-79.0.tree,OLD
1508,580,576,3281,5945,977,COIL20_old/25/COIL20-0.043120307493107635-5.0.tree,OLD
689,290,263,1585,2827,773,COIL20_old/25/COIL20-0.014524624599449809-71.0.tree,OLD
320,120,170,817,1427,471,COIL20_old/25/COIL20-0.025006159643043147-17.0.tree,OLD
689,290,263,1587,2829,774,COIL20_old/25/COIL20-0.014319423485356697-73.0.tree,OLD
515,224,204,1194,2137,696,COIL20_old/25/COIL20-0.02055684803263963-50.0.tree,OLD
818,334,297,1820,3269,815,COIL20_old/25/COIL20-0.012642207411133144-81.0.tree,OLD
444,158,213,1094,1909,598,COIL20_old/25/COIL20-0.033327499720545495-7.0.tree,OLD
723,304,272,1647,2946,784,COIL20_old/25/COIL20-0.013602937066845788-76.0.tree,OLD
839,335,300,1858,3332,820,COIL20_old/25/COIL20-0.010547893844548184-89.0.tree,OLD
453,160,214,1083,1910,628,COIL20_old/25/COIL20-0.02924957150309304-9.0.tree,OLD
562,236,217,1307,2322,706,COIL20_old/25/COIL20-0.015841891627543014-63.0.tree,OLD
523,227,204,1207,2161,699,COIL20_old/25/COIL20-0.01918943056487088-56.0.tree,OLD
335,119,153,814,1421,493,COIL20_old/25/COIL20-0.02089016739324767-34.0.tree,OLD
451,155,213,1075,1894,627,COIL20_old/25/COIL20-0.030300960857739534-8.0.tree,OLD
523,227,204,1205,2159,699,COIL20_old/25/COIL20-0.019371739697443713-54.0.tree,OLD
697,291,264,1600,2852,773,COIL20_old/25/COIL20-0.01387030516432003-75.0.tree,OLD
320,118,151,783,1372,484,COIL20_old/25/COIL20-0.021966498062449658-27.0.tree,OLD
380,127,168,868,1543,524,COIL20_old/25/COIL20-0.026671673559876596-13.0.tree,OLD
324,120,169,826,1439,473,COIL20_old/25/COIL20-0.023901697220359175-20.0.tree,OLD
523,227,204,1206,2160,699,COIL20_old/25/COIL20-0.019369876667411523-55.0.tree,OLD
839,335,300,1859,3333,820,COIL20_old/25/COIL20-0.010431396247857272-90.0.tree,OLD
816,333,293,1811,3253,815,COIL20_old/25/COIL20-0.01197370565988548-84.0.tree,OLD
324,120,151,791,1386,490,COIL20_old/25/COIL20-0.021547095070422406-32.0.tree,OLD
